1lnz0ex	cars want see underground get hands ultra rare hypercars one protoypes surely get hands mercedes amg one high hyper porsche 911 gt1 straßenversion mid hyper mid high super top sports looking clk lancia 037 stradale high c sports mazda 787b mid super low hyper top c sports jaguar xj13 mid high c sports mid sports
1lnzozy	automotive technician programs currently live las vegas nv 33 years old interested cars whole life recently decided get automotive mechanics hobby currently pursuing bs applied mathematics minor physics looked community college aas automotive technology master technician program motorsport technology certificate achievement meeting advisor ensure assumption motorsport technology ca think eliminate confusion given credentials would allow work master technician motorsport technician would able work euro cars background given get additional training dealerships training programs heard ptap porsche ferrari technician program audi aep program would love apart experience skill set facilitate creation environment work high end automobiles heard programs difficult get young probability accepted low perspective possible hire specific brand technician shadow would possible still get accepted programs going uti requirement enrollment programs options aside path laid career hobby mind spending time money set finances music production data science etc money motivating factor education skill development personal garage would look pretty awesome even though hobby still see value acquiring appropriate certifications solidify experience reputation capable technician insight appreciated thank
1lnzp9o	taiwan property market banking industry perspective plenty talk taiwan housing bubble almost none actually happens behind scenes banking side thought might interest anyone equally baffled madness taiwan housing market background work adjacent taiwan financial industry personally worked multiple major banks taiwan course career either product team senior management level accountant commentary analysis purely reading insanity taiwan banking sector enjoy context first taiwan one developed economies escaped 2008 financial crisis relatively unscathed also means missed wake call major reforms systemic audit risk exposure real restrictions housing finance operates whilst us europe got meaningful regulation carried crazy dialled 11 past 25 years property prices skyrocketed wages barely moved mortgages gotten bigger longer somehow interest rates bar mortgage approval stayed low even though household incomes budged two decades holdings liquidity taiwanese banks keep scale prices market demanded get increasingly creative leveraging regulatory loopholes self assessed risk models capital rules allow lend many multiples actual holdings mortgages actually work taiwan moment sign mortgage agreement taiwan bank generates digital credit account books mortgage asset balance sheet money come bank deposits holdings created thin air system works called capital adequacy ratios car rules dictate much bank lend based capital actually hold taiwan globally basel iii banks required maintain something like 8 capital total risk weighted assets weird part mortgages considered low risk taiwan often assigned risk weight 40 even lower means bank issue 25 times real holdings mortgages basically debt leverage steroids regulation oversight approves risk models banks taiwan banking sector regulatory capture complete banks design risk models audit exposure simply report every 24 months operate capital requirements let leverage 25 1 mortgages like letting casinos set odds audit books government may review periodically entire system relies heavily self reporting including default rate closed book internal modelling assumption house prices always go tl dr taiwan banks issue 25 times holdings debt forms loans mortgages new loan mortgage allows bank lend even imaginary new money created buy house considered asset backed value property mean real world sellers walk away real liquid money sellers flex neighbours department store shoppers buying porsche suv expensive repair difficult drive safely taiwan narrow streets buyers get 30 40 years debt often retirement age assuming job done ai next year bank collects decades interest buyer defaults takes back house something real exchange money never actually existed whilst behind scenes every new mortgage creates fresh interest bearing asset bank new assets improve bank financial standing basel iii rules turn justifies issuing even loans using capital base actually increased material way would banks operate way pure profit maximisation socialised risk profitable business model human history create money digitally collect decades real interest payments things go sideways collateral real property plus government backing absorbs losses incentive structure completely backwards banks get immediate fee income loan origination processing insurance requirements guaranteed cash flow 30 40 years interest payments often exceed original loan amount real estate collateral appreciates loan numbers added database collateral becomes material asset bank event default bought non existent money government protection taiwan banks heavily state aligned meaning barely penalised defaults taxpayers always backstop major losses meanwhile risks diffused across society systemic economic instability pushed future longer loan terms minimised self assessed models conveniently classify mortgages low risk even though birthrate probably lowest world year significant proportion taiwan cognitive workers 30 40 jobs market face real risk unemployment due automation within next decade taiwan debt machine self sustaining artificial money creation inflates property prices justifies higher loan amounts generates fee income interest payments encourages lending everyone involved banks real estate agents construction companies even government property taxes profit keeping bubble inflating losers borrowers trapped decades debt society facing systemic financial instability time bill comes due today banking executives collected bonuses likely moved usa canada extended families like kmt kleptocrats old perspective healthy housing market leveraged pyramid scheme masquerading financial prudence fuelled wishful thinking peer pressure blind confucian subservience ever increasing mountain debt concentrating even wealth top whilst risk gets offloaded downwards wage suppressed working people want home normal family life sources anyone wants learn analysis clownshow banking regulations capital requirements taiwan banking bureau basel iii implementation official fsc documentation capital adequacy requirements lexology prudential regulation banks taiwan 2023 legal analysis current banking regulations global legal insights banking laws taiwan 2025 current leverage ratio requirements regulations bank international settlements basel iii framework international regulatory standards housing market data statistics taiwan housing crisis analysis news lens 2024 comprehensive data showing taiwan ranks 9th globally housing costs brookings institution rising housing prices taiwan 2016 historical analysis showing 70 price increase vs 12 wage growth news lens housing profits vs wages 2024 real estate profits grew 40x since 1985 wages less 4x trading economics taiwan housing index current housing price data global property guide taiwan market analysis historical price trends tax policy changes economic context ish ceic data taiwan household income official income statistics trading economics taiwan interest rates current benchmark rates news lens minimum wage growth analysis 2024 comparison wage growth vs housing costs across countries
1lnzqkx	911 exactly find name youtube title says 2020 911 carrera manual google shows images different looking car
1lo04ps	one adventure hot wheels porsche
1lo0hca	update rexy says june 2025 anyone got update regarding
1lo0m71	nice lighting local restaurant
1lo0ptx	grid mpx v1 en porsche 911 rsr simracing steering wheel hallo ik heb onlangs deze beide sturen kunnen kopen tweedehands maar persoonlijk vind ik niet dat er qua gevoel veel verschil tussen beide zit ok de porsche heeft extra scherm maar de grid heeft dan 2 kleine joysticks die heel handig zijn maar qualitatief vind ik beiden gelijk soms denk ik er om de grid te verkopen en de ascher artura pro te kopen de plaats graag jullie mening
1lo0qw8	regular adet 120tl stanbul merhaba elimdekileri çıkarmaya çalışıyorum regular adet 120 tl min alım 1k cars tekli adet 700 ikili 1200 uzun kartonlar üzerinde yazıyor yer stanbul güvenli bir şekilde kargo yapılır gönderilir ulaşabilirsiniz
1lo0rdx	cracked clearcoat porsche repainted roof 10 months ago recently went vacation hot desert area sitting sun appeared idk hell edges cracks perfectly square almost anybody seen thanks advance
1lo0s7k	pay delivery amount also pre order anyone help pre order stuff knd new thanks please help po
1lo0u97	pre ordered roxy porsche 911
1lo0ys2	weekly discussion thread june 30 welcome weekly discussion thread ask questions post rants brag game accomplishments race wins roulette drops etc forget join discord server gt7 daily races race track tokyo expressway south clockwise 4 laps car honda civic type r ek touring car garage provided car tires sm bop tuning specified fuel use 1x tire use 1x make dr c dr race b track spa 24h layout 4 laps car gr 3 garage provided car tires racing hard bop tuning brake balance fuel use 1x tire use 1x race c unranked race track suzuka circuit 10 laps car jgtc special event opponent cars provided car tires racing hard 1 mandatory pit bop custom tuning brake balance fuel use 1x tire use 1x sr changes enabled dr updates remain beware possible rain supplementary information regarding week daily race c bop nissan gt r nismo r32 90 535 hp 1148 kg porsche 911 carrera rs 993 95 454 hp 1119 kg lamborghini diablo gt 00 509 hp 1162 kg ferrari f40 92 478 hp 1250 kg nissan gt r gt500 99 498 hp 1270 kg honda nsx gt500 00 456 hp 1290 kg toyota supra gt500 97 487 hp 1270 kg mclaren f1 gtr bmw 95 467 kg 1230 kg bmw mclaren f1 gtr race car 97 383 hp 1150 kg subreddit game news known issues list general gt7 faq ucd lcd line engine swap list ticket drop rates bop info current game version wdt 1 60 release update thursday viewer campaign prizes delivered july 10 2025 claim awaits next previous thread
1lo1fm4	one lose sandbagging also another case someone lost evo ultima
1lo1fsu	reflection collections currently veteran players incentive collection get faster delivery times better daily rewards faster fuel refill collection tokens piling without smart way spend time limited collections imho trick help boost sales get back collection branded could add permanent collections including early season purple star cars ferrari 70y event porsche anniversary thoughts
1lo1k3o	clean 914 parked street prague cz
1lo1wl4	need help pay got flat tire need spare los angeles drive porsche cayenne suv hybrid need spare pls anyone help
1lo21uk	might love
1lo22zl	porsche gt3 sony a1 sel135f18gm x48
1lo2m9h	porsches popular understand luxembourg porsche mercedes bmw audi lexus etc luxury suvs comparable prices specific local reason porsche popular hear porsche dealership offer better deals porsche luxembourgish ancestors sort national pride thing exactly causing massive representation porsches among expensive cars swear 5 cars registered country black porsche cayennes
1lo2ru1	new garage mascot running 100 1k bhp
1lo2uha	trade republic sepa lastschrift mandat erfahrungen hallo ich möchte gerne meinen autokredit bei der porsche bank über mein trade republic konto abwickeln möchte ich getrennt vom haupt girokonto bei der hausbank haben hat hier jemand erfahrungen mit sepa lastschriftmandaten über tr werden diese zuverlässig abgebucht konto ist natürlich gedeckt ebenfalls habe ich eine iban danke euch
1lo2upr	last three models complete nfs collection 1 18 last three diecast collection complete need speed 1 18 diecast cars collwction models rose n largo porsche 911 nfs undercover joe polestar ks1 nfs heat asap rocky mercedes 190e nfs unbound
1lo3b4w	porsche
1lo3d35	porsche
1lo3q41	selling set mrp dm interested
1lo3tmf	worth hype
1lo3uzo	gt7 smart brain cells workin watkins glen daily gr 3 porsche 911 last lap chopper view
1lo3wni	behind scenes porsche daytona 24 scenes f1 movie
1lo3yj5	cream porsche 911
1lo432h	many days found 1 sandbagger found someone say win 3 race correct
1lo4bza	leasing rates m60 anyone else saw leasing rates m60 ridiculous high received quote 970 whereas m50 729 weeks back new quote even higher i5 m60 porsche macan nuts anyone else facing quote received mistake u k based
1lo4hxl	save2 ideas thinking replacing beloved piastri sargeant save 3 months 3 wins boo hoo story save idea looks best go idea 1 team nobodies basically cat team comprise drivers res core members needed anyone team drivers checo mick sarge latifi nyck amr alpine juniors etc res xavi bird maybe cto dan fallows stuff remain unchanged guys mentioned taken team replaced either juniors equal rated ai generated people idea 2 squads juniors teams required choose juniors past drivers pre 2023 oscar drive alpine kevin mclaren haas leclerc might go sauber well wants include porsche vcarb hyundai cat either porsche take vcarb squad use ai generated hyundai go ai generated ones idea 3 mixed squads teams field one male driver one female driver highest ovr ones squads juniors past drivers like idea 2 rbr likely go max hamda mclaren lando bianca alpine oscar abbi missing female academy drivers added 2025 dlc porsche hyundai undergo stuff idea 2 one pick
1lo4zq9	rare 930 turbo targa headed auction expecting hit 1 million
1lo51lx	op saw gt3 rs porsche 911 gt3 rs 992 1 gt silver indigo blue
1lo5d9q	hotel parking valet recommendations chicago porsche staying overnight downtown chicago around michigan avenue area marriott property would feel comfortable valeting porsche
1lo5eny	izmir içi 450
1lo5il8	slightly updated version eterna eta history recently started collecting eterna watches caused want dig deep eterna history understand eterna various eras collect go back beginnings eterna 19th century start 1930s great depression time eterna one many watchmakers making movements believe selling companies movements completely non standardized firm using different parts everyone struggling economically swiss government stepped save industry 1931 swiss government formed asuag allgemeine schweizerische uhrenindustrie ag english general swiss watch industry ltd government compelled eterna form eta sa 1932 comprising movement manufacturing absorbed asuag prominent movement maker asuag never subsidiary eterna continued collaborate meanwhile eta continued supply eterna movements eterna made movements throughout 50s 80s higher end watches centenaries kontikis etc eterna carried making first kontikis 1958 making wide range watches 60s 70s leading quartz crisis time quartz crisis swiss government stepped 1983 formed smh société de microélectronique et horlogerie asuag ssih owners tissot omega etc smh eventually acquired privately renamed swatch group 1998 however government merge eterna smh pcw bought eterna trying enter luxury watchmaking pcw stands portland cement pcw provided financial support support luxury market eterna navigated quartz crisis pcw ownership 1990s porsche design wanted become watchmaker contracted manufacturing watches iwc among others wanted build capacity house early 90s pd fractures iwc showing pd started working eterna design watches 1995 began acquisition process concluded pd full ownership eterna pd contract iwc ended around pd invested heavily eterna including opening markets around world pd boutiques 90s 2010s probably eternas best years opinion terms design quality several kontikis 2005 2015 also made watches like vaughan madison gorgeous adventic pd also encouraged eterna go back movement manufacturing 2003 swatch group petitioned government switzerland restrict sale eta movements companies group sort big deal time merger asuag movement monopoly fully assemble movements made ebauches companies like selitta soprod used assemble movements license 2013 swiss government finally gave swatch permission sell within group phased time allow companies adjust pd eterna designed system 39 compete eta 2892 modular movement allowed build various complications modules incredibly slim eterna intended sell watch makers excluded eta movements eterna used number watches including gmts royal kontiki adventic 8 day power reserve watch madison dress watches granges vaughan system 39 never managed get foothold market pd sold eterna city champ hong kong based conglomerate 2011 spend much time stage eterna life suffice say number amazing designs developed pd continued lines late 2010s however eterna lost global markets hit hard times manufacturing remained grenchen switzerland become chinese watch company final note pd years sometimes referred schneider era refers leadership dr jürg schneider managing director porsche design swiss watch operations think watches era woefully undervalued bracelets big part watch experience put eterna bracelets market today
1lo5oas	beautiful porsche neighborhood
1lo602h	red eye rival tier
1lo6fex	initial quality year 1 guess cx 90 cx 70 issues data
1lo6qj0	inherited 2015 golf tdi need advice long term reliability edit reviewed warranty information believe finally understand phase 2b 23y8 performed 2018 05 21 32 095mi dpf replaced 23y8 40k miles dpf warrantied 2050 06 25 appears forever tldr bone stock 2015 golf crua warranty need emissions system reliability performance economy would appreciate recommendations 10y warranty done done soon got car neglected state sitting several months crua engine tsi trim 55k miles diy maintenance including timing belt water pump filters fluids replaced brakes rotors tires front wheel bearings first timing belt decades cars timing chains difficult repair diagnostic computer code instrument cluster previous owner disabled seat belt warning needed pass safety inspection virginia think tuned cai restored bone stock get egr warranty work done dealer flashed stock new tdi 2015 porsche cayenne diesel three years sadly lost accident know emissions systems inevitably expensive issues son using golf away college gets good four hour 75 mph drive several times per year mostly rides bicycle campus short trips times per week know great car car job virginia subject emissions testing computer hookup inspect equipment one monitor ready pinch register college town emissions testing three year limit warranty gone improve reliability emissions systems goal reliability emissions test passing vehicle four hours away performance economy matter much besides obvious delete difficult source expensive diy work would tune tuning box help components usually fail first already egr issues slow close fixed warranty dpf usually next turbo anything prolong life components
1lo6qlc	ftr gt supercup last call entries last call entries ftr gt supercup 4h multiclass enduro featuring ferrari 296 challenge porsche cup 992 car race held silverstone green flag dropping 17 00 gmt 5th july 2025 dedicated race stewards real time protest system live broadcast youtube green flag tv automated caution detection racedirector software race run solo part team minimum sr ir requirement take part race welcome please drop discord server interested upon arrival please head registrations channel sign head general questions happy help
1lo6t86	show pocket car brought hw rlc porsche 959 today love darker spectraflame red color really makes lines flow b e u f u l casting one favorites monday pocket car
1lo6utp	fh5 h cr numerous super rare cars w porsche 911 gt3 r 23k hey everyone love get car u one 4 sale trade pls let know
1lo6vda	radträger porsche 997 targa gibt es für g fahrzeug einen träger den jemand empfehlen kann es sollten zwei rennräder drauf passen wenn es einen kombi aufbau gibt der auch für skier sinn macht noch besser danke
1lo6w31	joc de cuvinte pentru tine masini 2025 06 30
1lo7ffy	want meka support added game either overlord dae hyun mechanics engineers would fit support role perfectly overlord drone could healing dae hyun referenced lot lately porsche video voice lines christmas comic abilities dva stadium mode could see join ow lore like efi recently plus community asking dva related hero years
1lo7glt	started f2p account first sponsorship event locked car
1lo7irg	tesla model audi a6 e tron first impressions picked audi a6 e tron long journey searching successor 2016 tesla model 90d 9 years 84k tesla best car ever owned quality luxury basis experience made ev devotee go back car fantastic major issues replaced door handles upgraded chip amazingly reliable always put smile face esp stepped accelerator however getting old little things slowing great experience driving quality fit finish never great nothing compared well built german cars miss exhaustive search main criteria 300 mi range room luggage would consider sedan suv etc excite bit like well built appointed car high end focused list included tesla model lucid air rivian r1s mb eqe bmw i4 i5 ix porsche taycan cayenne launched audi etron gt q6 a6 s6 looking actually put order another model frustrated others caught unfortunately really havent updated car much even 9 yrs yes better tech bit range like yoke still modest changes still felt bit dated saw audi launching a6 s6 decided cancel order see one turned since many ways similar size wise hatchback really helps loading bike stuff aerodynamic cutting chase a6 really everything wanted tesla much better built solid car better driving experience contemplating s6 get specs special order vs a6 could get immediately prestige air suspension 20 tires ventilated seats b etc little s6 bit cooler looking faster a6 plenty fast lease car knowing first generation issues could thought would limit risk first impressions car looks great actually looks much better person photos think front grow time older audi grilles layout car fantastic trunk space perfect sportback really load lot needed bmw i5 lucid really disappointing trunks compared ix tons space drive much suv one car seats much nicer tesla really feel like cockpit road noise also minimal audi tesla always bit loud b sound system also def better air suspension seems great far smooth ride downsides miss tesla tech ui better hands app yet try supercharging magicdocks using ea use much anyway tesla really easy manage front also used battery updates much range left frunk also barely audi almost afterthought actually used mine lot tesla also miss sunroof audi transparent glass like opening times also fsd mine old used cruising changing lanes audi many safety features seem bit annoying get used customize miss lane change functionality full hands driving really made easier trust still lot get used audi think tech bit cluttered although like carplay hud battery status something getting used need see accurate also want see real range cold weather though say car really grown feel like hit sweet spot
1lo7jcf	missed opportunity get legends tour porsche able buy hear lots people saying buy online mattel go private seller
1lo7tm8	got
1lo7zyb	fh5 w porsche taycan cross turismo 20m
1lo82mo	c4s turbo radiators anybody use ebay winner aluminum radiators one original radiators 151 000 mile c4s finally gave anyone experience winner motorsport brand aluminum radiators ebay
1lo8ajx	porsche 935 78 turbo tomica recently porsche 935 78 turbo martini livery rough shape sure want try restore preserve play worn patina
1lo8bhz	porsche 911 buyer beware watching listing stay away seller watching 996 911 auction highly advise buying seller purchased car long story short delivered car oil half viscosity recommended 0w 40 caused engine spin rod bearing highway handful drives read full experience comments
1lo8fgd	wondering price gmeu 6 12 13 70
1lo8k9f	porsche gt3 vs talaria x3
1lo8rve	driver team stats list champions 20 seasons myteam career note run standardised 16 race season points race tallies comparatively low
1lo8szx	1960 porsche 718 rs60 39 1960 porsche 718 rs60 39 pilots e barth w seidel team porsche ag race 11th overall 1st 1 6 class le mans 1960 spark s9727 resin
1lo99qw	latest liveries sharecodes gto 285 497 830 jeep 900 455 075 dodge 144 866 786 corvette stingray 896 006 866 aston 552 259 512 escort 108 922 958 porsche gt3 550 040 587 bmw m3 573 607 887 gamertag svdw999
1lo9b69	print error picked one display one wheel swap upon deciding one open based card condition noticed cards bit different reason simple printing error fysa one card displays porsche car green stripe one
1lo9coq	late yet powsche 110 since last month climbing type like guy picture fomoing missed powsche around year already gave away porsche time ready
1lo9p5y	hit version jackpot shady walmart left six porsches pegs one challenger already opened porsche wanted another one keep box hunting like crazy centenario found two even know challenger thing today either
1lo9psp	kid play parents car
1lo9xtb	gerald game stephen king 1 jessie could hear back door banging lightly randomly october breeze blowing around house jamb always swelled fall really give door yank shut time forgotten thought telling gerald go back shut door got involved banging would drive nuts thought ridiculous would given current circumstances would ruin whole mood mood good question gerald turned hollow barrel key second lock heard minute click left ear realized least mood worth preserving noted unlatched door first place course sexual turn bondage games lasted long could said gerald however wearing pair jockey shorts look high face see interest continued unabated stupid thought stupid whole story either also little scary like admit gerald forget hesitated moment frowning little went across room dresser stood left bathroom door face cleared went watched lay bed arms raised splayed making look little like fay wray chained waiting great ape king kong wrists secured mahogany bedposts two sets handcuffs chains gave hand six inches worth movement much put keys top dresser two minute clicks ears seemed exceptionally fine working order wednesday afternoon turned back head sunripples lake danced wavered bedroom high white ceiling say lost lot charm never much begin add grinned heavy pink skinned face narrow widow peak hair black crow wing grin always done something much care quite put finger something oh sure makes look stupid practically see iq going ten points every inch grin spreads maximum width killer corporate lawyer husband looks like janitor work release local mental institution cruel entirely inaccurate tell husband almost twenty years every time grinned looked suffering light mental retardation answer simple course smile different matter entirely lovely smile guessed smile warm good humored persuaded go first place reminded father smile told family amusing things day sipped dinner gin tonic smile though grin version seemed save sessions idea gerald inside grin felt wolfish piratical maybe angle however lying arms raised head nothing pair bikini panties looked stupid retarded devil may care adventurer like ones men magazines spent furious ejaculations lonely overweight puberty attorney pink large face spreading widow peak narrowing relentlessly toward total baldness attorney hard poking front undershorts shape moderately shape size erection important thing though important thing grin changed bit meant gerald taken seriously supposed protest game gerald mean grin widened small inoffensive attorney teeth came view iq tumbled another twenty thirty points still hearing sure read like book supposed took lot seventeen years marriage get point thought usually pretty good idea going head thought something would seriously whack truth toots come read come see new scene old sex farce turn frown slightly always heard voices inside head guessed everyone although people usually talk talked bowel functions old friends comfortable bedroom slippers one however new nothing comfortable strong voice one sounded young vigorous also sounded impatient spoke answering question read sometimes toots want gerald really feel like bring keys back unlock something else get top want lie hands behind head know way sure want new voice asked really sure want sex man jessie closed eyes could make voice shut opened gerald standing foot bed front shorts jutting like prow ship well kid toy boat maybe grin widened exposing last teeth ones gold sitings sides dislike dumb grin realized despised let good good jessie corny new bullshit voice commented tres corny hooked thumbs waistband underpants like absurd gunslinger jockeys went pretty fast got past inconsiderable love handles exposed formidable engine love first encountered teenager pages fanny hill something meek pink circumcised five inches completely unremarkable erection two three years ago one infrequent trips boston seen movie called belly architect thought right looking penis attorney bite insides cheeks keep laughing laughing point would impolitic n idea came killed urge laugh know serious jessie mahout burlingame wife gerald sister maddy daughter tom sally mother one really ceased keys made small steely clicks locks handcuffs men adventure magazines gerald teenage years replaced pile skin magazines bottom drawer desk magazines women wearing pearls nothing else knelt bearskin rugs men sexual equipment made gerald look strictly hoscale comparison took behind backs magazines talk dirty phone ads 900 numbers ads inflatable women supposed anatomically correct bizarre concept jessie ever encountered one thought air filled dollies pink skins lineless cartoon bodies featureless faces kind revelatory amazement horror quite intense light flashed inside landscape disclosed certainly frightening stupid game fact time playing summer house lake long summer run away another year none affected hearing slightest chainsaw heard snarling away woods considerable distance much five miles maybe closer main body kashwakamak lake loon tardy starting annual run south lifted crazed cry blue october air closer still somewhere north shore dog barked ugly ratcheting sound jessie found oddly comforting meant someone else midweek october otherwise sound door loose old tooth rotted gum slapping swollen jamb felt listen long would drive crazy gerald naked save spectacles knelt bed began crawling toward eyes still gleaming idea gleam kept playing game long initial curiosity satisfied years since seen much heat gerald gaze looked bad looking managed keep weight still figure gerald interest waned idea booze partly blame drank hell lot first married knew booze old saw familiarity breeding contempt supposed hold true men women love least according romantic poets read english lit 101 years since college discovered certain facts life john keats percy shelley never written course died lot younger gerald matter much right right maybe gone game longer really wanted liked hot little gleam gerald eyes made feel young pretty desirable really thought seeing got look eye misled toots maybe misled maybe decide really really decide intend continue putting humiliation pretty much feel humiliated sighed yes pretty much gerald mean spoke louder first time gleam eyes flickered little good could hear seemed maybe things still okay great long time since things could call great okay gleam reappeared moment later idiot grin followed teach proud beauty said actually said pronouncing beauty way landlord bad victorian melodrama might say let let done voice much familiar intended follow advice know gloria steinem would approve care advice attractiveness completely practical let would done q e hand soft short fingered hand flesh pink capped penis reached grasped breast something inside suddenly popped like overstrained tendon bucked hips back sharply upward flinging hand quit gerald unlock stupid handcuffs let stopped fun around last march still snow ground feel sexy feel ridiculous time heard way could see way gleam eyes went like candleflames strong gust wind guessed two words finally gotten stupid ridiculous fat kid thick glasses kid date eighteen year went strict diet began work effort strangle engirdling flab could strangle time sophomore college gerald life described less control life life anyway bucking bronco ordered tame knew high school years horror show left deep legacy contempt suspicion others success corporate lawyer marriage believed also played part perhaps even crucial one restored confidence self respect supposed nightmares never completely ended deep part mind bullies still giving gerald wedgies study hall still laughing gerald inability anything girlie pushups phys ed words stupid ridiculous instance brought back high school yesterday suspected psychologists could incredibly stupid many things almost willfully stupid often seemed horrible persistence memories thought bang memories battened onto person mind like evil leeches certain words stupid ridiculous example could bring instantly back squirming feverish life waited feel pang shame hitting belt like pleased maybe relief felt pang came guess maybe tired pretending thought idea led another might sexual agenda business handcuffs definitely made feel demeaned whole idea made feel demeaned oh certain uneasy excitement accompanied first experiments ones scarves couple occasions multiple orgasms rarity side effects care feeling somehow demeaned one nightmares following early versions gerald game awoke sweaty gasping hands thrust deeply fork crotch rolled tight little balls remembered one dreams memory distant blurred playing croquet without clothes sun gone never mind jessie things consider another day right important thing getting let loose yes game game gone playing simply gerald wanted longer good enough loon voiced lonely cry lake gerald dopey grin anticipation replaced look sulky displeasure broke toy bitch look said jessie found remembering last time gotten good look expression august gerald come glossy brochure pointed wanted said yes course could buy porsche wanted porsche could certainly afford porsche thought might better buy membership forest avenue health club threatening past two years porsche body said knowing diplomatic feeling really time diplomacy also exasperated point cared whole hell lot feelings happening frequently lately dismayed know supposed mean asked stiffly bother answer learned gerald asked questions almost always rhetorical important message lay simple subtext upsetting jessie playing game occasion perhaps unknowing tune one elected ignore subtext answer question means still going forty six winter whether porsche gerald still going thirty pounds overweight cruel yes could downright gratuitous could passed image flashed eyes looked photograph sports car front glossy brochure gerald handed blink instant seen chubby little kid pink face widow peak stuck innertube brought old swimming hole gerald snatched brochure hand stalked away without another word subject porsche raised since often seen resentful amused stare seeing even hotter version stare right said sounded like fun exact words sounds like fun said supposed mistake little goof little slip old banana peel sure tell husband lower lip pooched like baby huey getting ready tantrum know dropped gaze saw something like gerald version mr happy wilted bit apparently mr happy heard change plans gerald feel like well hell note took whole day work spend night means tomorrow morning well brooded moment repeated said sounded like fun began fan excuses like tired old poker hand yes headache yes really shitty pre menstrual cramps yes woman therefore entitled change mind yes actually big lonely frighten bad beautiful brute man lies fed either misconceptions ego two frequently interchangeable could pick card card new voice spoke first time spoken loud jessie fascinated find sounded air inside head strong dry decisive control also sounded curiously familiar right guess say really sounded like fun breaking away way used got name door rest type thought maybe could bounce bedsprings little sit deck dig quiet maybe play scrabble sun went actionable offense gerald think tell really want know said last five minutes telling various ways wanted goddam handcuffs still let impatience boiled fury god gerald stopped fun almost soon started thick brick would realized mouth smart sarcastic mouth sometimes get tired gerald get head really set something sweet low come close reaching whose fault like like jessie like like bit going bad worse horrible scariest part fast happening suddenly felt tired line old paul simon song occurred want part crazy love right paul may short dumb know okay right subject handcuffs much like tell changed mind something want cuffs hearing realized dawning dismay really gerald still one turn back goddamned inconsistent goddamned sarcastic love jess hate goddam lip always wiped palm left hand across pouting rosebud mouth looked sadly poor put upon gerald saddled woman gotten forest primeval reneged sexual obligations poor put upon gerald showed sign whatever getting handcuff keys bureau bathroom door unease changed something else back turned become mixture anger fear could remember feeling twelve brother goosed birthday party friends seen laughed har har preety fonny senhorra theenk funny though laughing hardest hard actually doubled one hand planted knee hair hanging face year advent beatles stones searchers rest lot hair hang apparently blocked view jessie idea angry ordinary circumstances much aware turns mood temper gone laughing froth emotion filled understood would something simply explode doubled one small fist punched well loved brother mouth finally raised head look blow knocked like bowling pin cried really hard later tried tell cried surprise pain known even twelve hurt hurt plenty lower lip split one place upper lip two hurt plenty done something stupid nine nine day age kids stupid stupidity fear fear something ugly green froth anger embarrassment would put sun cause explode truth first encountered day well inside water well poisoned goosed william sent bucket one come filled scum squirming gluck hated supposed really hate caused strike deep stuff scared years later discovering still still infuriated well put sun thought without slightest idea meant damned want argue fine points gerald get keys fucking things unlock said something astounded first grasp registered first change tone usually spoke bluff gruff hearty sort voice charge pretty lucky thing us tone proclaimed low purring voice familiar gleam returned eyes hot little gleam turned like bank floodlights upon time see well eyes squinted puffy slits behind gold rimmed spectacles yes indeed strange case mr happy mr happy wilted bit seemed fact standing taller time could remember although probably imagination think toots processed information finally returning last thing said amazing question time got past tone sense words came fully understand felt rage fear crank notch somewhere inside bucket going shaft another slimy dip scumload water filled microbes almost poisonous swamp copperheads kitchen door banged jamb dog began bark woods sounding closer ever splintery desperate sound listening something like long would undoubtedly give migraine listen gerald heard strong new voice saying aware voice could picked better time break silence deserted north shore kashwakamak lake handcuffed bedposts wearing skimpy pair nylon panties still found admiring almost found admiring listening yet know much days talking time really important hear finally listening kneeling bed looking previously undiscovered species bug cheeks complex networks tiny scarlet threads squirmed thought gerald liquor brands flushed almost purple similar swath crossed forehead color dark shape definite looked like birthmark yes said new purring voice word came yeh usss listening jessie certainly good walk bureau get keys unlock one rattled right wrist headboard unlock one rattled left wrist similar fashion right away little normal painless mutual orgasm sex returning normal painless lives portland pointless thought left one normal painless pointless lives portland perhaps perhaps little overdramatization handcuffed bed brought person discovering probably well left one case suggested new bullshit voice indiscreet contradict idea heard voice voice begin rise unmistakable beats pulses rage continue screwing around teasing go straight sister find divorce call joking want play game something really incredible happening something never would suspected million years grin resurfacing coming like sub finally reached friendly waters long dangerous voyage really incredible thing though really incredible thing grin longer made gerald look harmlessly retarded made look like dangerous lunatic hand stole caressed left breast squeezed painfully finished unpleasant bit business pinching nipple thing never done ow gerald hurts gave solemn appreciative nod went strangely horrible grin good jessie whole thing mean could actress call girl one really high priced ones hesitated added supposed compliment god name talking except pretty sure knew really afraid something bad loose bedroom spinning around around like black top also still angry angry day goosed gerald actually laughed talking minute believing talking dropped hand onto right thigh spoke voice brisk weirdly businesslike want spread part game enjoyed post forget upvote leave comment want read full story behind snippet let know comments share
1lo9ztj	thoughts badge combination
1loa8y5	grounding error porsche charger came unplug charger car left throughout weekend although done charging friday night notice anything today came grounding error apparently unplugged charger car came back see could reset charger already back normal anyone else seen
1loadjy	pretty nice pulls last 2 weeks bentley porsche daily objective packs megane a110 update premium carbon rest tag cfs
1loaeeg	rr3 gt2 club sport upgraded changed paint wheels gee porsche make car
1loai9q	mb 70 years special edition porsche 911 love casting matchbox color good shiny orange would better choice opinion versus matte version nonetheless great one share tge group happy hunting
1loaliy	auto focus porsche 911 gts hybrid time upgrade
1loam8s	guy rage quit like said posts hurt ego think stand chance tune car race first first 2 laps spun porsche tries kill suspension recall viper passed caught way back passed last 30 seconds straight see wanted take bad props opinion man raced rage quit last turn thought people rage quit call duty science purposes race mic talk wrap people loose minds wreck
1loamev	pieces collection
1loaoxz	new old collector story used collect hot wheels back kid 90s loved played like crazy integral part today fast forward 2020s 30 year old learns asd spectrum struggle adhd started developing coping skills improve life given info one involved creating reward system motivate tasks difficult accomplish due adhd needed something physically tangible would rewarding enough make task worth cheap enough emptying wallet every time finish task enter hot wheels course week scoured local stores well picked packs ebay stock reward bucket haul really care finding th sth rare stuff want buy cars think cool mainlines premiums get mixed together bucket complete task hard time get randomly pick car bucket mystery get coupled chance pulling premium adds incentive also couple team transports target twin packs pictured stash away use big rewards reaching task milestones tldr excited back hot wheels space 20 years later wanted share haul along story event anyone else interested creating similar reward system help achieve hard things life
1lob5ih	join envy simsports porsche cup sprint series starts july 9th register today whether rookie starting seasoned pro countless victories thrilling porsche cup championship welcomes skill levels race us iconic tracks experience excitement competitive sim racing 8 round championship series features 35 drivers track 2 races 20 minute heat race 25 minute feature race fixed setups 40 fuel 1 fast repair 15x 10x incident system race calendar 1 circuit gilles villeneuve july 9th 9 00pm 2 watkins glen july 9th 9 00pm 3 sebring july 9th 9 00pm 4 spa francorchamps july 9th 9 00pm 5 imola july 9th 9 00pm 6 monza july 9th 9 00pm 7 road atlanta july 9th 9 00pm 8 road america july 9th 9 00pm event schedule us eastern time practice 8 00 pm 45 min open qualifying 8 45 pm 15 min race 9 00 pm race envy simsports clean competitive racing league dedicated ensuring clean competitive racing participants free entry plus understand may able make every race race love see track open everyone newcomers seasoned drivers welcome participate registration secure spot late sure follow us sim grid upcoming races also make sure join envy simsports community discord today keep updates events porschecup iracing simracing envysimsports
1lobarl	mostly great experience far many people tend post negative experiences thought post positive ones picked ex90 twin motor ultra may next day got sideswiped driver stop stop sign ex90 spent next 6 weeks shop good news volvo family members ex90 totally fine fault car sustained far worse damage collision also means time got car back already software 1 3 17 experience regarding version got car back promptly took 1000 mile road trip great report highlights favorite things end list gripes bugs far good news drives great comfortable driver passengers suspension steering great like 1 pedal driving setting fit finish great volvo design build great seats adjustable comfortable model got ventilated seats massage seats front massage functions pretty good stronger varied cars tried battery range charging great range advertised range miles seem count accurately normal conditions doubt could get 300 miles using entire battery full empty using battery way designed used using middle 70 roughly 80 10 charging back 80 still get 200 miles charges enough road trip charging fast nice able use tesla non tesla chargers evgo 350kw charger saw charging rates 200 kw car sustained charge rate 80 kw way 80 quiet inside absolutely quietest car remember driving b w sound system sounds great goes well quiet interior need loud hear make loud want real rotary volume control within driver reach plus cameras parking sensors great good field view good image quality work directions little animations pop show specific obstacles detects distance really helpful pretty sure park car spots try without help cameras pilot assist intuitive reliable let co drive hundred miles mishaps attention monitoring good bugs automatic lane change worked 90 time flip driver display mode shows assistant status live animation green rectangle car changes lanes pretty cool steering wheel buttons everyone complaining chintzy capacitive touch buttons across auto industry pretty good compromise react touch anything press react touch mean show overlay driver display button touched use figure button finger without looking steering wheel also works dark though could added lights buttons key phone key working great life always wanted live carrying separate credential car apple devices recent phone watch support uwb loaded key know one primarily talking car seem matter experience perfect 90 great 10 bad leave couple notes gripes section bugs gripes driver settings seem work created separate driver profiles wife paired specific key us ever seen car automatically switch profiles based key presented even keys far vehicle hours uses stays whichever driver used car last switch profiles center display works error refuse switch profiles also save restore seat position least never seen means practice every single time switch drivers need go center display switch profiles manually adjust seat mirror positions would really nice explicit save restore buttons seat position like cars right even override instead depending software get right magic every time remote functions phone app iffy mean remote lock unlock remote climate start sometimes works mostly sometimes app says work car actually hard cloud system receive commands phone relay car confirm car acted relay back phone app roundtrip seems fail somewhere 80 time even phone car great cellular connectivity software version think rely able remotely occupant alarm super annoying dog kids want able turn permanently forget lock car dog moves kids move alarm goes happened bunch times already good news alarm even loud point anyway know risks need nanny want able leave dog car sometimes right 10 tap process leave car turning climate trust app turning occupant sensor locking car alarm gone never notified phone app believe supposed notifications enabled app get alerts car unlocked example never phone app tell car alarm alarmed listening music builtin system switching carplay audio voice calls text messaging dangerously loud pop speakers mean specifically phone paired via carplay use siri interface text messages voice calls carplay active car screen builtin google maps active car screen someone calls use hey siri command loud pop phone takes audio system volume normal car lost gps position compass orientation made navigation pretty broken rebooted center display got better seen inconclusive reports tcam reset across volvo models helping obvious documented tcam reset ex90 charging tesla supercharger charge rate oscillated 150 kw 36 kw tried hot day sun single huge charging station 56 chargers major freeway know heat issue power issue signaling issue know issue car charger adapter know would happen make charging take 10 minutes longer also volvo supplied nacs adapter pretty easy get pretty hard take frunk pretty hard open close compared evs tesla porsche live think person family using also live g turn signal cancel behavior unintuitive hard figure even know harder actually perform cars cancel turn signal right press left volvo cancel turn signal right press lightly right lightly far enough make click motion invokes temporary 3 blinks auto cancel sometimes turned way past click canceling pressing far click interpreted additional temporary blink instead cancel existing permanent blink gesture rather press way like cars 2 window switches 4 windows driver door stupid garage door interface homelink support frustrating omission recent touchscreen based cars comparing tesla porsche well problem easily solved visor clip remote planning going retro comparing tesla porsche nice able set names locations button right one pop right location old school hardware remote feel like step back side note saw somewhere recommendation tailwind device end run round tailwind app android variant car actually tried set tailwind devices installed app car seem work fear even get working going nearly seamless used tesla porsche end falling back visor remote anyway digital keys unintuitive set already left longer post sub net create one digital key volvo center console send single phone phone share key people devices create keys found unintuitive wish better documented center console ui car manual corner cases digital key behavior might surprising got really early charge car charging stations busy phone watch phone sleep focus mode watch low power mode apparently turns uwb radio devices car recognize standing next car recognize somewhat disappointing scary especially given complaints behavior like oh locked realized wrong turned phone sleep mode standing right next car still nothing happened phone sleep mode walked 30 feet away reapproached car lights come handles come welcome good builtin charging pad finicky recent iphones sometimes works sometimes triggers phone enter wallet mode instead sometimes even phone happily charging away suddenly center console show blue warning bar top moving objects charging area avoid interfering charging phone objects charging area despite length lists pros definitely outweigh cons hope fix driver profiles settings bugs add permanent switch occupant sensor dog mode really happy car offering 1 3 18 software update ota first thing monday morning thread sub promised
1lobg91	powsche rise miss strongest cult space ever seen powsche around 185 lows month ago 80 today alone buys rolling volume creeping believers accumulating people recognising value see powsche tokenized arguably strongest cult earth narrative relatable much wider audience crypto degens moonboys hold early bitcoin vibes known holding long term visions working silently background get deserve tokenized car culture tokenized lifestyle tokenized luxury powsche next none space fundamentally others dream multi chain ecosystem real utility 15 months old dev team since launch held porsche giveaway flew holder dubai expenses paid given well 100k community given away countless trezor wallets merch tokens list goes ride financial freedom jump fasten seatbelt head subreddit r powscheonsol find way official telegram community bookmarks section welcome speak ask questions may regarding project team actively encouraging stupid challenging questions aim transparent helpful possible powsche ca solana 8ckishhjdhjv4luoirmluhqg58cukbyjrtcp4z3mcxnf ethereum 0xc5cb2e3f9e9b04f36ff24b9d392be211f81abc85 powsche always wins powsche always delivers powsche always thrives
1lobgcg	porsche shared gt7 scapes official instagram
1lobgxm	powsche rise miss strongest cult space ever seen powsche around 185 lows month ago 80 today alone buys rolling volume creeping believers accumulating people recognising value see powsche tokenized arguably strongest cult earth narrative relatable much wider audience crypto degens moonboys hold early bitcoin vibes known holding long term visions working silently background get deserve tokenized car culture tokenized lifestyle tokenized luxury powsche next none space fundamentally others dream multi chain ecosystem real utility 15 months old dev team since launch held porsche giveaway flew holder dubai expenses paid given well 100k community given away countless trezor wallets merch tokens list goes ride financial freedom jump fasten seatbelt head subreddit r powscheonsol find way official telegram community bookmarks section welcome speak ask questions may regarding project team actively encouraging stupid challenging questions aim transparent helpful possible powsche ca solana 8ckishhjdhjv4luoirmluhqg58cukbyjrtcp4z3mcxnf ethereum 0xc5cb2e3f9e9b04f36ff24b9d392be211f81abc85 powsche always wins powsche always delivers powsche always thrives
1lobhm5	powsche rise miss strongest cult space ever seen powsche around 185 lows month ago 80 today alone buys rolling volume creeping believers accumulating people recognising value see powsche tokenized arguably strongest cult earth narrative relatable much wider audience crypto degens moonboys hold early bitcoin vibes known holding long term visions working silently background get deserve tokenized car culture tokenized lifestyle tokenized luxury powsche next none space fundamentally others dream multi chain ecosystem real utility 15 months old dev team since launch held porsche giveaway flew holder dubai expenses paid given well 100k community given away countless trezor wallets merch tokens list goes ride financial freedom jump fasten seatbelt head subreddit r powscheonsol find way official telegram community bookmarks section welcome speak ask questions may regarding project team actively encouraging stupid challenging questions aim transparent helpful possible powsche ca solana 8ckishhjdhjv4luoirmluhqg58cukbyjrtcp4z3mcxnf ethereum 0xc5cb2e3f9e9b04f36ff24b9d392be211f81abc85 powsche always wins powsche always delivers powsche always thrives
1lobyax	meet chill stoner friends really interested drag racing gets boring really quickly interested circuit sprint drifting sometimes cross country road racing say absolute fastest best slowest either really wanting chill smoke cruise show car share tips tuning paint say want race every single time get either really big toxicity drama immature mentalities behaviors word person closed minded narcissistic mentality make block 99 9 content satisfied chillin well keep mind tolerate condone delusional mentally unstable behaviors really like befriend people around age group say 25 30 40 people lazy actually want events races build tune car best pretty good tuning drag racing homies actual talent outcast actually decent game forza motorsport alike hmu fwm usually bish driving absolute dog piss outta one many many porsche sumthin shitty douch bottle player toxic minded mfrs stay away
1lobyey	random creations 1 ford mustang estate 2 audi q4 e tron pickup truck 3 bmw x3 pickup truck 4 porsche 911 targa pickup truck 5 mazda mx 5 miata sportback 6 polestar 2 estate 7 citroen c3 convertible honestly q4 pickup mustang estate looks best imo
1lobyrt	want trade either one new porsche chase pay difference mrp f2f deals mumbai
1loc00d	latest add ons latest add ons mrp collection growing steady rate started late december 2024 point space anymore place cars usually open uncard cars
1loc4g2	porsche secret weapon imagine powerboat champion youngest ever camel trophy winner also main person responsible helping nelson piquet recover awful injury almost lost foot 1992 indianapolis 500 crash vincenzo tota porsche team doctor lived enough highlights thousand lifetimes still absolutely crucial everybody works today 33 years career
1loc86f	wts porsche design chronograph 1 limited edition hodinkee new
1loc91m	porschepaglu
1locl5f	carreras del domingo madcar f1 multiplayer
1locpgu	far good
1locqw2	iso need bad black gt3rs need black gt3 rs reasonable rate
1locu04	negotiating cpo purchase hey looking join club first porsche purchase specifically looking low mileage 2021 2023 porsche cayenne gts cpo understand dealer dependent anyone success negotiating anywhere 8 12 list price
1locx2o	would spend 2 3k x pipe straight pipes exhaust shop take mufflers add x pipe soul missing something
1lod2ah	finally almost completed custom porsche 987 wow really long journey took 1 5 years def learnt lot especially epoxy putty slamming wheels spraying wld post final result put car tgt clear coat still drying hahaha
1lod3cs	finally almost completed custom porsche 987 wow really long journey took 1 5 years def learnt lot especially epoxy putty slamming wheels spraying wld post final result put car tgt clear coat still drying hahaha
1lod4b3	new front valence options hello going get new front valence repaint im getting soon wondering front valence options kdb seems like best right tried inquire air option getting error message might table also answering phone anyone pictures either one installed heard kdb one line sometimes near wheel well
1loe15f	red porsche know even recognize sometimes wonder check space saw would know would recognize words would think reaching would stay quiet smile knowing part us still exists lines like drop hint something small something catch shoot text
1loe15i	1978 porsche 930 turbo finished cockney brown cork leather interior cloth accented sport seats powered turbocharged 3 3 liter flat six linked four speed manual transaxle
1loe1ak	powsche road victory looking low mid cap token infinite potential look powsche narrative community blast billions given time withheld worst trenches still comes top unlike many tokens powsche linked dying trend time dependent narrative porsche biggest luxury brand entire world shows life many would like live join us rev engines
1loe35i	score
1loe7lm	red porsche know even recognize sometimes wonder check space saw would know would recognize words would think reaching would stay quiet smile knowing part us still exists lines like drop hint something small something catch shoot text
1loec5e	found first ferrari pretty good haul today
1loek9w	wtc 800 sardegna easiest grind wtc 600 tokyo expressway profitable horrible took enjoyment game found list profitable races tried whatever cars came across one caught eye sardegna road course wtc 800 needed car several kilos ballast plus one old gt forum post someone 2022 era 2002 viper later foolproof method setup car used car got lucky via 6 star roulette 917 living legend 976 brake horsepower active aero dream pp 800 go de tune get 800 time want compromise iconic v8 full potential going old forum post got work spending thousands credits 917 much available power restrictor race computer ballast started ballast surprise managed net right 799 96 using 200kg ballast benchmark result none hp compromised cost 29 extra kg race bought fully customizable manual transmission see could toss ballast could room pp increase went newly installed transmission set top speed 420kmh completely made 8th gear obsolete transmission tuning however mot affect pp turned downforce 500 front max back left back alone went front tuning later 799 91 pp beast faster 0 400m time 8 95 able pull higher rotational g tldr setups setup mk donor car porsche 917 tires racing hards allowed use tire except inters wets even additional parts ballast 29kg leave everything else unchanged pp 799 96 setup mk ii donor car tires additional parts fully customizable manual transmission additional tuning front downforce 545 transmission top speed 420 using auto adjustment leave everything else except unchanged pp 799 91
1loeret	umfrage porsche audi konfigurieren bachelorarbeit servus alle autointeressierten ich schreibe aktuell meine ba zum thema psychologische optimierung von fahrzeugkonfiguratoren es geht darum ein auto porsche oder audi zu konfigurieren und danach einen kurzen 5 minütigen fragebogen auszufüllen wie lange ihr das auto konfiguriert ist eure sache wenn ihr keinen bock mehr habt skippt ihr zur survey vielleicht hat ja der eine oder andere lust mitzumachen ist natürlich alles anonym und nur im namen der wissenschaft
1loew9b	used e tron gt europe hi looking used e tron gts country netherlands seem pretty cheap figure check first watch couple ones available one particular noticed december 2021 model 50k km 30k miles asking price 55k euro catalog price 130k 58 depreciated considering original price pretty loaded config including air suspension upgraded leather interiors seem outstanding recalls seems one past another one available specced even 146k catalog value price september 2021 outstanding 931b recall high voltage battery overheating 80 seems rather serious initially looking used taycans yet done research e tron gt yet like know kinds offers good anything look positive negative like e tron gt little faster sportier base pre facelift taycan seems significantly cheaper well especially compared 4s know taycan e tron gt annoying issues know enough yet tedious enough stay well clear resolved big deal also 100 warranty things heard part wait times long apart older models also post facelift ones still significantly expensive missed 2024 5000km taycan cross turismo 105 kwh battery 80k 45 depreciation year considering go least 90k commonly still 100k porsche dealers new e tron gt somewhat rare decide worth 30 35k newer model although value increased range significantly greatly appreciated anyone chip currently 2023 tesla model peformance looking trade business administrative reasons probably cheaper drive privately case
1loewcs	beautiful panamera pts
1loewfh	chance cf hand currently floating 10th 20th
1lof7ze	recent finds vacation blast able stop couple different wallys along way
1lofcsa	mn cars coffee 6 28 25 multi
1lofdvv	new missions 30 6 25 60 seconds airtime porsche cars 2 days drift 24 000 meters 3 days
1lofh8a	two birds one stone
1lofhex	wheels seen 991 1 carrera
1lofouz	today good day
1lofyse	runnings win get custom 68 camaro dope casting
1log5wj	dia cinzento em são paulo contagem caracteres 3699 palavras 629 linhas 25 ruas de são paulo nunca estiveram tão frias os rostos nunca tão embaçados sinto como se enxergasse mundo por meio de uma névoa cinza e espessa cidade da garoa como previsto faz jus à sua fama e presenteia todos uma chuva fina e gelada que faz com que temperatura despenque durante dia sou retirado meu devaneio pela mudança sinal de pedestres que se mostra favorável à minha passagem não hesito em atravessar depressa despreocupadamente nem mesmo quando uma porsche preta e cara quase passa por cima de mim não acho que faria alguma diferença já faz um tempo desde última vez que senti verdadeiramente vivo adentro cafeteria em minha frente cheiro de café e leite de amêndoas espalhado pelo ar causa náuseas aceitei esse emprego quando estava desesperado agora só empurro com barriga até que eu receba doce alívio da demissão visto meu avental coloco minha touca ridícula e posiciono balcão pronto para enfrentar mais um dia cheio de hippies malditos de classe média alta e mocinhas fitness com seus budgets e calls e qualquer outra merda supérflua em inglês que inventem dia se arrasta lentamente ao som de músicas da renner e café péssimo sinto sufocado cheiro intenso deixa doente e luz amarela faz sentir tontura cada segundo sinto como se em algum momento mundo fosse desabar completamente e eu fosse ficar preso nos escombros agonizando gemendo desejando morte boa tarde tudo bem uma moça gordinha e baixa se aproxima balcão roupa colorida destoa resto público da cafeteria assim como boa educação boa tarde meu nome é emmanuel que posso ajudar digo utilizando completamente minha cota de simpatia mês eu queria um café você pode por favor fazer um latte para mim fito por alguns segundos os olhos castanho escuros reluziam em minha direção um sorriso amigável iluminava completamente sua expressão depois de tanto tempo levando porrada é estranho encontrar um pouco de gentileza claro com leite de amêndoas vaca ou de coco pego canetão pronto para anotar copo leite de vaca tento usar minha caligrafia mais visível para garantir que pedido seja feito corretamente não é sempre que atendo um anjo que conhece palavra por favor quando levanto os olhos vejo uma loira se esgueirando na fila os peitos de plástico digladiando com os lábios preenchidos para ver quem é mais artificial erm licencinha moça se vc puder dar uma aceleradinha por favor eu tô com pressinha sabe moça murcha e olha os olhos cheios de um incômodo contido puta loira vagabunda quanto ficou 20 reais mas qual é seu nome pra eu colocar copo cora ela abre um pequeno sorriso que nem coralina fico ali parado por alguns segundos observando analisando absorvendo eu não sei direito porque e nem vou fundo para entender mas quando dei por mim estava sorrindo como um idiota estranho sentindo leveza da moça quer saber esse é por conta da casa digo entorpecido por toda aquela atmosfera quentinha e aconchegante cora sorri iluminando completamente local sério valeu seu pedido jájá fica pronto viu sinta se à vontade para escolher uma mesa assim que moça se senta dirijo minha melhor carranca à loira afe finalmente gordinha ali demorou demais ela levanta os olhos celular e encara com os óculos escuros não vai anotar não com uma onda grande de satisfação aponto para uma plaquinha que havia acabado de posicionar balcão e vou embora fechados para almoço eu sei nem todos os heróis usam capa eu estou voltando escrever agora e gostaria muito de um feedback sincero dessa flash fiction obrigada por ler até fim
1log6z1	picked boxster pretty excited picked immaculate speed yellow 2000 boxster local doctor car collection got take 79 year old mother weekend cruise birthday got fine drive summer see want keep send road 236 internal production code related tyres 413 18 993 turbo look wheels 421 front cassette compartment 446 wheel caps colored porsche crest 454 automatic speed control 490 sound system 6 speakers 502 produced valmet plant uusikaupunki finland 535 alarm 315 mhz 551 wind deflector 584 storage box incl speakers engine cover 659 board computer 692 6 disc cd changer becker porsche cdc 3 x70 stainless steel door entry guards logo x71 alu look instrument dials x97 gear lever knob aluminium top x98 handbrake lever aluminium inlay xla polished stainless steel exhaust end xmy arctic silver painted roll bar xsy yellow seat belts yellow stitching leather seats nice touch replaced cassette holder oem cubby
1log7ye	target haul today haul target sth 67 mustang clean
1log82h	bmw g82 m4 gt4s hunting porsche 718 gt4 watkins glen favorite shots race glen week
1logip2	looking 911 jersey hopefully allowed looking cpo 991 1 gts porsche monmouth california would first 911 aside power wheels 911 turbo cabriolet toddler would anyone jersey willing swing give test drive want make sure look like garbage person buy dinner
1logs1a	face slapping scenes part ii feel like stuff bothers lately bls included post revenged love 00 00 00 21 depth field 00 22 00 40 love mecanics 00 41 01 10 happy end 01 11 01 16 kinnporsche 01 17 01 25 find part post best slap feeling bit annoyed things keep coming across lately thus gonna use post slaps satusfying context imao make better people say things like hope know posting scenes series one romanticize sa sexual assault toxic content unconsented kisses forced scenes character forces adapted manga sa etc etc etc sit right seeing problems point dissuade people watching making feel like ashamed liking well seeing also sit well taste bls things enjoy formed trial error never know capable handling limits lie tested nuances way something conveyed screen matter whatever something simple complex grey morally wrong nuances little details used convey something screen makes us react differently thing seen shown quite come like much love yes year 2025 everything time passed mean stop portryed screen place everything dictate creators bls add works creative freedom one satisfactions one working making series movies jbls problematic sensitive content already removed adapted even personal weatherman utsukushii kare happy end really heavy stuff removed still get hate content everything sanitized nowadays way might negatively impact small number people either watch something old mature enough target series movies always morally good things sometimes wants provokative break boundaries norms spark conversation think people follow might guess made want post last ep depth field attempted sa one characters slipped matter reason right know know scene romanticized soon advances rejected attempt stops nothing scene looks romantic author scriptwriter director fault people romanticize watch way people might react something deter someone making people would romanticize whatever want matter intention us able tell difference even someone perceive scene differently compared us depth field bls characters things might seem right might put people revenged love recent one give us right make people feel bad still liking even end disliking see point opinion apply everyone police every little thing meet expections standards manga upcoming jbl proper way write love based sa scene bet kept non consensual thing might shown screen related scene trashed hell back us watch bls either adults mature enough know getting mature enough research starting something see reflection real life fictional story watch entertainment believe draw line shown screen real life stay away watching things mature enough understand finish also want say words bls included post revenged love love series love second couple much love main couple love scene cracks matter many times watch ii depth field chosen include post scene mentioned much learn scene konno personality shine reaction like way hell let happen like way let mistake better slaps real hard hard flies across room hard see way hayakawa comes realise right away depth field solid amazing iii love mecanics slap p yeewah satisfyingg female rage iv happy end sorry really sorry get vibrator hit scene head iconic funny time feeling everything watching mixed feeligs v kinnporsche way tankhun wielded baking pan across vegas head worthy wielding thor hammer lmfao thankhun bow ur honor ur worthy sir
1logweh	kinf porsche hungary
1logxmb	ultimate car geek trip germany hello everyone know dozens people asking go comes automotive attractions germany offer planning two week stay begining munich end frankfurt september 2026 hopefully catch autoshow list places would like see missing bmw welt museum bmw group factory autostadt wolfsburg porsche museum stuttgart porsche factory stuttgart mercedes museum amg factory affalterbach get sponsored tour nurburgring frankfurt also hoping get chance drive autobahn though frankly honest like american drivers still think worthy
1logxt9	nurburgring track day fulfilled dream today drove nordschleife 718 gts sharing track beautiful specimens
1loh95w	boomer car club mostly gripe lol frequent whole foods sundays get last bits weekly groceries store part large mall complex 4 layer parkade mall hill one parkade entrances leads directly top layer one side complex enters bottom top level open air parking entrances stores main entrance whole foods parkinglot devided sections one way roads center section directly next front whole foods bunch boomers gather show cars exclusively old white men shuffle one oldster porsche next take like 60 parking grocery store entrance stand around clumps parkinglot kinda sucks parent trying get groceries toddler dodge try find remaining spot walk longer would otherwise maybe put complaint mall areas block much also cafe right like entrace whole foods guess thos spot edited spelling
1lohd1h	found today
1lohkpu	favorite porsche mine 911 gt3 rs forza edition
1lohrdw	gauge cluster short tac bounce common short locations porsche shop rn getting bearings gauge cluster started shorting shortly taking common issues caused usually fine little bit startup new fuse 15 minutes short shorts car tuned tacometer also needs minute two warm begins responding seems like corroded connection something first project back disassemble cluster reflow solder joints clean corrosion issues fixed fix
1lohwst	broken rocker arm 2016 cayenne vr6 engine got 2016 cayenne 90k miles friend free exchange favor however diagnosed broken rocker arm damaged cylinder head told car ran low engine oil eventually started smoking exhaust brought porsche dealer inspection report attached hope fix thing keep drive car starts fine abnormal noises smoke little bit drive though check engine light read obd sometime see code rocker arm common problem engines worth going trouble replacing broken rocker arm throwing dice hope runs fine labor intensive replace rocker arms cam gears back side engine require engine perform task found used engine matching year 2016 50k miles local yard 4k someone swap engine 1k would
1loi0sm	definitely worth 999 gold nice j4 pack
1loi296	making collection historic race cars year 2000 need 6 fill garage ideas preferably looking cars replicated almost exactly like look real life accept minor deviations long sort obvious
1loi8mg	porsche taycan 4s let know really photography 2 months follow instagram like shotbycinnamon
1loi9bw	fh5 w rare car list h credits trades hey guys got list cars looking buy mainly looking spending credits quite cars willing trade anything let know sure work deal want ford fiesta st 2023 honda ridgeline baja trophy truck hot wheels pontiac firebird hyundai 98 bryan herta hyundai ioniq6 hyundai kona n hyundai ioniq 5n lancia delta s4 1984 mg mg6 xpower 2021 morris minor series ii traveller morris mini traveller nissan z nismo 2024 pontiac gto judge 1969 porsche 92 gt team 911 2017 renault clio r 2010 rivian r1t 2022 toyota sports 800 1965
1loiczd	fh5 h lots rares sale w credits hey guys got updated list cars sale send dm interested anything happy work deals multiples cars sale abarth 124 spider abarth fiat 131 alfa romeo 8c amc rebel ats gt bentley flying spur bmw e92 m3 gts 2010 bmw m5 cs 2022 bmw i4 edrive 40 cadillac ct5 v blackwing dodge challenger srt super stock extreme e 58 mclaren racing extreme e 5 veloce racing extreme e 42 xite racing team ford gt 66 le mans ford mustang svt cobra 95 ford mustang svt cobra 03 formula drift 64 forsberg nissan z gmc syclone hdt vk commodore mclaren artura know backstage let go cheap mercedes amg e63 mercedes amg gt black series mercedes e55 amg wagon mercedes 500 e nio ep9 noble m600 plymouth belvedere plymouth barracuda porsche 911 gt3 rs 23 porsche 911 turbo 23 porsche 911 rallye renault megane rs 250 10 know backstage let go cheap raesr tachyon speed subaru wrx 2022 toyota camry 2023 toyota chaser gt twin turbo toyota soarer 2 5 gt
1loihym	water dripping panamera dear recently purchased 2018 hybrid panamera found nice puddle underneath car believe coming condensation air conditioning agency bought told normal nothing worried never car amount dripping attaching video took soon parked home suggestions something normal porsche cars panameras thank insights
1loii6v	looking comet sr w modded plate either bennys f1s one car away finishing porsche garage comet sr modded pm add psn solar_8345
1loin83	dude also wife alzheimers divorced died 102 second false accusation
1loinrb	options installed 2019 cayenne currently looking buy 2019 cayenne e hybrid came across good car options car well specced
1loiq7x	update aldar rök nasjonal samling rework guide nation towards greatness vidkun quisling either upholding democracy shield implementing bourgeois solidarism turning towards deep rural norway protector st olaf fatherland proclaim fører prime architect party leads charge nordic socialism univerist mysticism ragnarok circle tree overthrow quislingist regime give norwegian people destiny calls neo pagan totalitarian racialist state shall reclaim glory aryan viking conquests proclaim birth new world got kritarchy authdem somalia change leader disappear anymore hubert h humphrey cannot huey successors tree fix russia getting decision annexing north kazakhstan italy longer able release half libya shared event chain also made unique colonies also releasable states owned subject fix cosmetic checks accounting alt leaders calogero vizzini pacific states fp tree longer locked despite winning war cases nat france taking cnt owned rif also takes rio de oro australasia keep wrong ideology group tree puppeted fix garde noir cof ministers imamate mountain republic bypass focus ottoman alliance exist subject added gerald l k smith union state generals fixes annexations regarding urda pishpek fixes units deleted afghan civil wars fix iceland possibly declaring independent republic canada uob somehow puppeted earlier plebiscite focuses haiti tree dominican war also account old game rule psa socdems get huey long treaty signed cal tex case huey elected pres 1936 ottomans longer able azerbaijan rp membership focus already faction added actual cores forming arabian federation iraq split fernando po state fix possible broken integration annexation bosnia making illyria remove core drina loyalty route added game rules haiti prohibition weed event lermond renames socdem party coalition prohibition fix united cossacks able ee conquest decisions nations rp puppet assyria able peace ottomans fix natpop bukhara via mujahideen auto restoring monarchy psa longer able declare reunited usa went secession helped mac usa still exists locked tot synd ireland joining rp added proper check radsoc one uob 3i adolfo agorio added new leader natpop uruguay electing tito formed yugoslavia longer drop cosmetic tag crimea tatarstan bashkiria properly included paneurope formable annexation fix transbaikal air force investment focus adding natspirit aksumite formable ethiopia give core djibouti even exist tag yet added sylvia pankhurst council communism possible uob post war leader kenney chairwoman separate annexation event sudan conquered without egypt switched venetian election around radsoc venetia liberia electable socdem arp leads coup council try restore old republic japan asking us pacific islands properly transfer case agree added portrait picker grant iii radsoc slot bolivia led bautista saavedra mallea added event frances decide pondicherry come vynnychenko going council com branch get subideo switches radsoc added reuben paniora general new zealand get enlarge maori battalions focus ireland radio free scotland event chain anymore already war uob bucharest owner auto take bukovina provinces case galicia annexed cases added bypasses focuses siam indochina fp tree case already puppeted socialist longer invite nations war faction counter rev brits fix quentin roosevelt created correctly two cases due getting wrong type jeffersonianism getting sun ra alt leader nyc csa longer grant trait boosting specific ideologies stability morale mechanic transamur longer affects player jacques romain longer noiriste instead uses negritude represent indigenist beliefs soviet karelia longer puppeted russia soc russia established ukraine makes kuban puppet inherit kuban puppets fix osipov possibly getting red tinted autocracy tot added william borah scott w lucas paul douglas us presidential candidates william knowland psa one black nationalist nyc deal devil gets cores states gets also keep kimbanguism subideo got even switching powell sun ra alt leaders added james hanna mccormick general ulster fix decision defending southern rhodesia going away even natal already afghanistan decision attack central asia longer skip khiva canadian invasion focus natspirit longer disappear uob capitulated still exists byzantine greece forming diocese properly lose cores claims lands thus allowing trade eachother added raymond moullec paul ortoli louis de villefosse rené émile godfroy louis kahn admirals commune france charles platon robert jaujard admirals national france luigi gherzi general sardinia yngve schoerner admiral sweden vecihi hürkuş general ottomans bedřich albrecht general bohemia taneki hisamura tomio hara generals japan félix verdeja bardales general carlists leslie skinner august vollmer dave brubeck generals psa charles wesson general usa zizhen general lkmt jesus miranda vargas mateo capinpin generals enrique jurado jose andrada jose francisco ramon alcaraz admirals philippines walter matthau general nyc baring dakar conference properly transfer states nfa belgium added available bypass check canada imperial fed focuses dealing old foes forming imp fed transfer nations puppets canada also miss rest india terms coring delhi core previously added various scientists erich müller ernst kniepkamp erwin aders gustav ludwig hertz hans von ohain hellmuth walter henrich focke hermann burkhardt konrad zuse kurt tank manfred von ardenne max otto kramer otto hahn werner heisenberg walter dornberger wilhelm hadeler adolf butenandt germany added ferdinand porsche herbert wagner igo etrich max valier otto robert frisch austria aleksei isaev boris chilikin boris malinin fyodor petrov georgy langemak igor tamm mikhail koshkin nikolay dukhov vladimir kotelnikov russia alan turing barnes wallis charles lillicrap frank whittle james chadwick john cockcroft nevil shute norway dorothy hodgkin paul dirac rosalind franklin union britain bernice weldon sargent charles f goodeve canada walter zapp baltic duchy asen yordanov bulgaria niels bohr denmark stanisław ulam galicia ernest walton ireland kārlis irbītis latvia antanas gustaitis lithuania jerzy dąbrowski marian rejewski dymitr zaleski poland heorhii volyk kostiantyn chelpan kostiantyn kalinin kyrylo synelnykov mykhailo hurevych serhii koroliov ukraine anton fokker netherlands ede teller györgy jendrassik jános neumann leó szilard miklós straussler oszkár asboth theodore von kármán hungary qian xuesen wang pu wu ta qing chien shiung wu league eight provinces ljubomir ilić pavle savić svetozar k popović serbia émile rimailho louis renault robert esnault pelterie national france mark oliphant ruby payne scott australasia bedřich albrecht georg placzek ludvík očenášek bohemia auguste piccard switzerland alfred renard georges lemaître karel bossart belgium homi j bhabha delhi vecihi hürkuş belkıs özdoğan mustafa nan remziye hisar ottomans albert björkeson bo lundberg yngve schoerner sweden gaetano crocco two sicilies mario castoldi italian republic enrico fermi giovanni giorgi nello carrara socialist italy françois hussenot frédéric joliot curie irène joliot curie louis kahn marcel bloch pierre david commune france hideo itokawa jirō horikoshi keiji fukuda shin ichirō tomonaga taneki hisamura tomio hara yōji itō yoshio nishina japan emilio herrera linares juan antonio suanzes alejandro goicoechea omar félix verdeja bardales blas cabrera felipe esteban terradas illa virgilio leret ruiz spain john henry manley andrew mckee arthur william sidney herrington charles wesson emory land john charles niedermair karl probst peyton magruder j walter christie william h tschappat edward curtis wells edwin mcmillan leslie skinner paul pigott robert h goddard vannevar bush william francis gibbs ernest lawrence carolyn parker percy lavon julian samuel p massie mary jackson lawrence h knox marie maynard daly may edward chinn various american factions peter buck new zealand tweaked checks liberia lingbergh fordist path cor account alt leaders appear added maynard c krueger 1948 candidate radsocs csa benjamin gitlow possible alt leader lovestone scott attempted coup fails fix german intervention bread ending ukraine stopping instantly added josefina guerrero spy phillippines dino crocetti spy nyc raymond burr spy psa russia properly remove treaty minsk gearing war first fp focus fix white ruthenia demands rcw getting wrong response back moved ludwig e katterfeld iww election foster successors andré matsoua starting radsoc slot leader tekeland unique subideo added checks restored russian tsars tvo fergana peasant path rule turkestan national france releasing kluge weimar germany make revnat nfa subideo releasing deutsche aktion variant puppet also accounts various different subideos maurras successors added terrismo herrerismo batllismo subideologies uruguay various changes improvements norway alongside new trees democratic norway able elect social conservative bondepartiet 1936 elections 1951 available auth dem quisling also tree received buffs make enjoyable 3 paths specific flavour events democratic monarchist quisling join entente russian faction depending russia ideology membership reichspakt available sweden embraces syndicalism aspects norway experience overhauled industrial military trees well tweaks syndicalist route fix liberia going war portugal demanding guinea even already possible fix win lose delhi war wolrd news events firing afghanistan time added nuevo ideal nacional subideology perez jimenez venezuela nacionalismo manuel carles peronism juan peron argentina duplessism maurice duplessis quebec francoism rafael franco paraguay community movement adriano olivetti italy fix union minere leopoldville focus get reintegrated start war main congo rebel factions got defeated adela pankhurst switching natpop australasia use new conservative feminism subideo eric campbell also legionarist default subideo
1lojam9	porsche 911 turbo downpipe weld affection link shop
1lojcda	porsche delivery bad day
1lojcui	1 32 die cast uni fortune scion fr toy cars spotted display checkout line local athome store last week found one red two white versions sell 5 99 15 coupon bought white fr nice looking platinum colored porsche 918 spyder one assortment fairly proportional size compared fr purchased couple hot lava versions years ago match daily driver uni fortune fr collection
1lojivl	land sicht nachdem ich im april viel lehrgeld mit derivaten bezahlt habe und die macht von x posts einer mächtigen orange mit großem ego kennengelernt habe habe ich erstmal abstand genommen und etfs bespart und günstige aktien gekauft nach der bundesligasaison habe ich meine borussia dortmund aktien abgestoßen und mir erlaubt mit dem gewinn zu zocken allerdings mit kleineren hebeln von maximal 20 und dann im grünen auch mal mit kleinen beträgen raus zu gehen als porsche letzte woche auf 40 gefallen ist habe ich meine nvidia aktien abgestoßen und einen höheren dreistelligen betrag gesetzt als es freitag abging bin ich leider viel zu früh ausgestiegen aber dafür ging es heute mit apple und coca cola wieder gut weiter bin eigentlich ein großer fan von rheinmetall aber der aktuelle stand ist mir persönlich zu riskant mich für long short zu entscheiden vielleicht ist es noch zu früh weil ich immer noch mit verlusten dastehe aber ich möchte mich bei euch affen für eure posts bedanken die mir viel geholfen haben den markt im blick zu behalten und ein kleiner appell nicht zu gierig zu sein sorry für den längeren text
1lojmqj	fanatec csl dd 8nm settings settings guys running driver game im tuning wheel using rss gt3 ier porsche cup strength feels fine main issue getting good amount road feel without noise sandy feeling wheel sure csp setting driver setting used able feel cracks road feels like mashed potatoes driver settings sen auto ff 100 ffs peak ndp 15 nfr nin int 4 fei 90 100 depending car 100 spr 100 dpr 100 game settings kerb 10 road 18 slip 12 abs 10
1lojrhr	enjoying washington 997 2 c2s great drive yesterday already done 3000km month half ownership mountains amazing car first mod dsc controller pasm porsche put factory better ride improved handling
1loju9f	transformers dotm dino bought dance death dino honestly know feel bout looks cool rly finicky
1lok4n0	balıkesir içi takaslık
1lok55b	hello ideas could put game im sorry grammar 1 tuning 1 1 last 2 digits licence plates could made letters 1 2 none spoilers gamepass needed highest 1 3 higher rates upgrades price good player feel diffrence levels small 1 4 roof indicators civilians would great job vans minivans suvs rp 1 5 fuel tank upgrades would great cars small fuel tank make chases longer 1 6 tow hooks adac 1000 could add attachment car tow truck would let tow cars 1 7 suspension high wheel radious good looking body kits classic tune things make jdl look cool 1 8 roof racks cars 1 9 back flashers teams 2 civilian 2 1 smaller prices farm shop 2 2 lower prices hospital bill like europe us 2 3 adding wanted level trying hit paramedic firefighter adac worker bus driver truck driver deal damage 2 4 working chemist buy bandages later 3 fire department 3 1 front bumpers fire commander suvs 3 2 speed pd variants 3 3 fire extinguisher vould used faster hose limited usage time 4 rescue departament 4 1 strecher could used transport patient hospital works like handcuffs used downed players 4 2 aed fill 25 health recharge takes 45 seconds 4 3 front bumpers emergency doctor suvs 4 4 speed ad pd variants 5 patrol police traffic police undercover 5 1 spike strip slower effective stop stick 5 2 xp gained everything pain get perfect taser sek steal arrest wants porshe 5 3 riot shield blocks everything 10 seconds recharges 30 seconds 6 adac 6 1 adac vehicles immune traffic violations signals 6 2 challenges make gameplay fun boring 7 bus driver 7 1 add taxi diffrent subjob vehicles 8 truck driver 8 1 make steering easier truck trailer 8 2 higher xp please getting 0 pure pain 9 criminal 9 1 remote control also controlling traffic lights traffic radars would give use 9 2 time bombs c4 dont activate rp cool planned actions videos 9 3 smaller time wait rob places higher rewards private servers 10 10 1 please add bmw e65 bkm 7 mercedes benz w 221 stuttgart luxus sorry grammar errors im polish made night currently 23 40 thank reading much german version 1 tuning 1 1 die letzten beiden ziffern auf nummernschildern könnten als buchstaben dargestellt werden 1 2 keiner der spoiler sollte einen game pass benötigen oder nur der höchste 1 3 höhere raten für upgrades bei gleichem preis als guter spieler kann man den unterschied zwischen den levels spüren aber er ist zu gering 1 4 dachblinker für zivilisten würden sich bei vans minivans und suvs für rp hervorragend machen 1 5 tank upgrades wären ideal für fahrzeuge mit kleinem tank oder würden die verfolgungsjagden verlängern 1 6 abschlepphaken für den adac für 1000 könnte man einen aufsatz einem auto kein abschleppwagen anbringen mit dem man andere fahrzeuge abschleppen könnte 1 7 höhere federung radradius und andere attraktive bodykits oder klassische tuning elemente die jdl cool aussehen lassen 1 8 dachgepäckträger für autos 1 9 rückleuchten für alle teams 2 zivilisten 2 1 niedrigere preise im hofladen 2 2 niedrigere krankenhausrechnungen da wir uns europa und nicht den usa befinden 2 3 hinzufügung eines fahndungslevels für den versuch einen sanitäter feuerwehrmann adac mitarbeiter busfahrer oder lkw fahrer zu treffen fügt keinem von ihnen schaden zu 2 4 chemiker man kann verbände kaufen mehr dazu später 3 feuerwehr 3 1 frontstoßstangen für feuerwehr suvs 3 2 gleiche geschwindigkeit wie die pd varianten 3 3 feuerlöscher der als schnellerer schlauch verwendet wird aber nur eine begrenzte nutzungsdauer hat 4 rettungsdienst 4 1 trage kann zum transport von patienten ins krankenhaus verwendet werden funktioniert wie handschellen nur bei niedergeschlagenen spielern 4 2 defibrillator aed kann 25 des gesundheit aber aufladen dauert 45 sekunden 4 3 frontstoßstangen für notarzt suvs 4 4 gleiche geschwindigkeit wie bei den pd varianten 5 streifenpolizei verkehrspolizei undercover 5 1 nagelsperre langsamer aber effektiver stoppstock 5 2 mehr xp für alles es ist mühsam einen perfekten taser zu bekommen nur um vom sek verhaftet zu werden er nur porsche 5 3 schutzschild blockiert alles für 10 sekunden und lädt sich dann 30 sekunden lang auf 6 adac 6 1 adac fahrzeuge sind bei eingeschaltetem blinker immun gegen verkehrsverstöße 6 2 mehr herausforderungen um das gameplay unterhaltsamer als langweilig zu gestalten 7 busfahrer 7 1 taxi nur als separaten nebenjob mit mehr fahrzeugen hinzufügen 8 lkw fahrer 8 1 lenken mit einem lkw mit anhänger einfacher machen 8 2 mehr xp bitte von 0 auf 0 zu kommen ist eine qual 9 krimineller 9 1 fernbedienung die auch ampeln und verkehrsradare steuert nutzt es öfter 9 2 zeitbomben wie c4 aber ihr müsst sie nicht aktivieren mehr rp und coole features für geplante aktionen und videos 9 3 kürzere wartezeiten für raubplätze oder höhere belohnungen auf privaten servern 10 sonstiges 10 1 bitte fügt bmw e65 als bkm 7 und mercedes benz w 221 als stuttgart luxus hinzu entschuldigt die grammatikfehler ich bin polin und habe es nachts erstellt es ist aktuell 23 40 uhr vielen dank fürs lesen
1lok5vl	race participation credit program questions wanted clarify things member must score championship points race session qualify looking splits results porsche cup unless dead last turn lap get points even bottom split guy one lap got 2 points easy enough tick box right need score championship points race session complete least 50 number laps completed class winner class says class mean split division porsche cup race 17 laps driver score points first bullet point also 8 5 9 laps race odd number laps truncate example winner race car class ran 17 laps would need complete 8 laps versus 9 laps okay scratch 8 laps 8 5 9 complete least 50 number laps completed class winner class bit worries last season raced exclusively pcup fixed open definitely got lot laps week however got bit distracted gt3 gtp done 1 race pcup zolder bloody warm humid moment uk racing evening want check first 2 bullet points make sure understanding correctly anyone confirm correct interpretation much appreciated thanks ps yes know max credits 10 easily cover series wanted ask make sure understanding interpreting rules correctly
1lok6pr	balıkesir içi takaslık
1lokcv1	pts british racing green gt3 touring god tier spec
1loknhs	bmw m4 gt3 tyre issue m4 starting click managed get 2 15 spa tt tweaked setup hours mainly enjoyment one issue though get rear tyres hotter fronts temp window fine 80 90 always 4 9 degrees fronts balance car feels decent managed get rid unwanted understeer every gt3 find ideal temperature profile fronts rears m4 loosened front arb springs dambing stiffened rear dropped rear wing 2 1 added rake moved bb back tweaked brake wents also tried adjust driving style porsche mclaren deeper trail braking fellow racers able get excess scrub fronts keep rears hotter
1lol1lp	blower motor replacement advice recommendations hi ran issue fan ac blow air grueling summer weather research believe issue blower motor anyone encountered issue recommendations replacement go mechanic purchase replacement part thanks much advance model porsche cayenne 2016
1lol418	blower motor replacement advice recommendations hi fan ac porsche cayenne 2016 stopped working air blows research believe issue faulty blower motor anyone encountered issue recommend replacement go mechanic also recommendation get replacement part thanks much advance
1lol5hz	blower motor replacement advice recommendation porsche cayenne 2016 hi ran issue fan ac blow air grueling summer weather research believe issue faulty blower motor anyone encountered issue recommendations replacement go mechanic purchase replacement part thanks much advance model porsche cayenne 2016
1loloow	recommend color paint protection film ppf vinyl wrap 10 reasons hey everyone run auto style ppf sugar grove il wanted share something see lot people want protect car paint change look know difference vinyl wrap color paint protection film ppf today started wrapping mercedes gt500 amg matte black color ppf owner wanted stealth look also serious protection rock chips scratches road debris gone thinking wrapping car 10 reasons color ppf usually better regular vinyl wrap 1 10 year warranty vinyl wrap 3 5 years color ppf 10 years peace mind 2 real paint protection vinyl looks color ppf actual protection rock chips scratches swirl marks uv rays 3 self healing tech light scratches disappear heat sunlight vinyl 4 best luxury cars luxury cars need real protection mercedes bmw tesla porsche color ppf keeps looking new 5 hides flaws got faded paint scratches color ppf hides looks like fresh paint job 6 easy clean hydrophobic top coat easier washes stuck grime 7 premium finish ppf looks like paint richer deeper factory like vinyl 8 peeling bubbling vinyl lifts bubbles time quality ppf stays tight clean 9 resale value good paint higher resale ppf protects original paint underneath peace mind get custom look stress scratches rock chips one downside vinyl color options want neon chrome pink vinyl care protecting expensive luxury car color ppf smarter move help drivers sugar grove naperville aurora chicagoland curious color ppf want see examples check www autostyleppf com happy answer questions thinking wrapping car ama matte black color ppf matte black ppf 10 years warranty
1lolovk	fett jalopy 811 880 984 car porsche mission r
1lolox7	mustang corvette gt3 drivers spa 24 title ir important rough pace send message got mustangs porsche running endurance id like run corvette
1lolq6t	fett jalopy 811 880 984 car porsche mission r
1lolqz6	fett jalopy 811 880 984 car porsche mission r
1lols28	fett jalopy 811 880 984 car porsche mission r
1lom5ew	explain normal vs individual drive mode got new macan gts w sports chrono going configuration found normal mode set suspension height suspension mode exhaust mode start stop etc save hitting save key also within vehicle individual settings configure many settings quite many example exhaust menu via menu really difference point customizable normal differently customizable individual custom custom b exact functionality setup methods misunderstanding something missing something entirely
1lom9ei	porsche gt spotted
1loma5m	new wheels quick backstory ordered low optioned 22 718c really regretted spec ing boxster wheels vs caymans come standard fast forward able find lightly used boxster wheels reddit 981 recently get new tires went 18 michelin psas4 goodyear eagle f1s decided put time ceramic coated wheels went oem taycan panamera center caps really happy came think wheels represent classic porsche style love new tires far
1lombcj	porsche gt spotted london
1lomfce	mail call 3 silvia silhouettes collection really nice porsche got patrol make custom car friend patrol real life
1lomfxl	production milestones app stumbled across info porsche app production milestones five photos looks like car production line pretty cool husband get cayenne
1lomgb0	help race 17 rough world japan purple porsche beat literally using x class koenigsegg almost maxed parts shop
1lommoy	first score 3 months collecting never got lucky scalper left ferrari bent corner know th still peg thought see ferrari wild till winter holidays
1lomxew	gt3rs spotted first time spotting gt3rs wild first time seeing generation gt3rs
1lon6ou	gattaca turbo
1lonije	clear tail lights obligatory eugh clear tail lights comments come flying already decided white 991 1 destined go clear however struggling find said clear tail lights seem back order everywhere elsewhere getting conflicting info told need part number 991 631 145 12 others saying 991 044 900 15 991 044 900 57 right part tried looking online searching oem part numbers left confused someone community could point right direction would grateful
1lonwic	m3 older gen porsche currently 2024 m3 comp goes next car porsche casually looking 2017 porsche 911 carrera gts wondering feel m3 vs 2017 gts 2009 etc noticeable modern 24 compare older porsche sorry open ended question really sure put want get ppls thoughts suggestions input thanks
1loo3vw	bad spot breakdown weekend 24 hours spa one major incident blanchimont involving 112 mclaren porsche mclaren moving slowly racing line struck speed drivers walked away mclaren driver taken medical center checks thankfully cleared
1loovr2	tips using comfort access 2023 taycan ct4s comfort access think means able walk recognize unlock present handles open rear hatch wave foot open frunk swipe hand sideways front porsche crest logo lock doors touching indent door handles carrying keyfob course practice seems happen always recognizes unlocks approach opening rear hatch foot gesture works maybe 1 2 time opening frunk hand gesture works maybe 1 4 time often feel silly repeating gesture results locking doors touching indent works 2 3 time might require holding finger 2 3 seconds releasing trying times rare work quickly immediately read manual tried tips found foolproof method mostly end using keyfob open frunk lock car button hatch open hatch works every time really comfort access feature anyone similar experience know tips make work better likely software bug something wrong car user error holding wrong
1loowyb	accurate price estimate antique porsche possible hello inherited 1989 porsche 911 yes awesome use finance visualization site called kubera feature allows enter vin via company called vinaudit add value assets first entered car system popped value 144k outrageous recently corrected changed 96k assume also high find accurate even consistent value sites nature vehicles look comps auctions value whatever get someone wants buy thanks help
1lop2ja	porsche 911 997 turbo raw drive mountains took porsche 911 997 helen mountain georgia drive completing make car super fun let know guys think style video would appreciated
1lop3qp	porsche 911 997 turbo raw drive mountains took porsche 911 997 helen mountain georgia drive completing make car super fun let know guys think style video would appreciated
1lopad8	elite box 4 0 android auto pcm 4 1 hi friend 2018 panamera pcm 4 1 trying get android auto working anyone tried using elite box 4 0 android auto love hear feedback 1 pcm version connected 2 connection stability 3 responsiveness 4 similar native aa experience 5 abilities beyond native aa experience thanks advance
1loq171	fh5 h porsche 911 turbo 23 911 rallye 23 w 26m trade jaguar f type svr 20
1loq2cw	buying used panamera 2018 ehybrid hi folks looking buy used panamera e hybrid 61k miles anything look know getting rennlist mechanic would help check battery health test drove car battery charged 2 miles range left hard determine battery health unless charge use things looking asking price dealer 49k
1loq4h8	grind spa easy 1 5m grinding spa paid online dividends keep racing clean people
1loqs3u	thoughts thank community helping decide new 2026 porsche gts spend money slightly used evo overwhelming number responses ran fold thank believe made decision cancel gts build delivered october lamborghini rapid increase pricing porsche gives pause last v10 evo believe hold value well plus looks stunning evo priced 257 000 11 000 miles thoughts car
1loqu7a	19 hours 23 cars run energy decided try 24 hour race 2 3 stints every days going great ai started dropping like flies sure progressive saves ai strategize well seem bad time dealing energy management longer races anyone else issue
1loqxll	exactly 1 year today 911 turns 1 hell car use daily
1lor5bb	first porsche car purchased black olive gt4rs stranger performance cars 2 s2000s track regularly absolutely fell love color 4rs drove around corner giving back dealership ppf choice strong armed add adm sound car makes amazing buying experience abysmal agreed price backtracked demanded pay 20 000 front ppf ceramic coating ended somewhere middle wasted whole lot time trying look forward awesome ownership experience
1lorf27	got first chase came 10 app ifollow constantly
1losbpt	still getting used focal length 85 gmii amazing
1loserd	new player got lots gifts clam sorry stupid question u see gifted nice cars forza team claim reason thanks
1losfau	trials quadrifoglio ownership 1 year owners update exactly 1 year since purchasing 2024 alfa romeo giulia quadrifoglio kinda similar post post similar length ownership going compare car supra think supra probably lemon though think made good arguments car even reliable still feel good product start negatives since probably interested negatives reliability dealership concerns 1 month ownership noticed drops oil garage took local alfa dealership diagnosed front crank seal seep ordered parts replaced car gone 2 days catch loaner asked pay uber said within vancouver live nearby suburb cost difference would 10 dollars got argument told mercedes bmw would treat people way guys already trouble treat customers took risk bought brand gave paid ride home back around 900km take anymore went local back roads race mode beat crap car huge grin face unfortunately front rotors developed hot spots started shaking braking rotors pads replaced warranty surprise probably entirely fault pads bedded properly two circumstances check engline light came upon starting car throttle pulsing infamous service electronic body control obd2 reader handy noted 10 different codes thrown cases cases knew probably nothing cycled ignition cel went away thousands km second time happened months later car started leak area back dealership gone 2 days mention cel issue really care probably software bug ended updating ecu software directly addressed bug softawre misread battery voltage late model giulia quadrifoglios told 10 years servicing car two cars front crank seal leaks mine 2023 speculated bad batch seals circulating update fixing leak rotors pads upgraded pads well car issues matter beating much harder used one time android auto froze system restarted build quality issues rattle front guage cluster surround already knew would issue purchasing car purchased foam instantly resolved day 1 small rattle driver side door audible really crank base music dealer applied foam significantly better small rattle overhead lights seems solved let see comes back winter dailying issues car low clearance 458 longer wheelbase centre car prone hitting taller speed bumps mindful fuel economy 15 2l 100km car begs drive like asshole almost launching every red light love big pillar mirror situation means visibility hampered left turns onto pedestrians heated seats steering wheel carbon bucket seats mild winters problem car idles nearly 1000 rpm gotta apply bit brake pressure get car sit still red light get fatiguing resolved putting neutral biggest problem dailying car hill start assist feature bit intrusive sometimes letting go brakes get car creep slight incline gotta give second move forward backwards performance issues front alignment limited sure done way front camber adjustable sits 0 5 degrees currently car handles incredibly well neutral worried messing brakes even porterfield r4s pads stock rotors okay get slight brake fade intense touge session brakes little feel behave differently depending feel best race mode pretty much drive car race mode get completely different animal torque limits like dynamic mode first 2nd possibly gears car feels much faster brakes better sensitive throttle stiffest suspension settings locked mode caviat get traction stability control none found issue ps4s tires hooks well chassis communicative well balanced lovely qualms driving car hard race mode bumpier roads bottom car low driving fast enough positives reliability 7 5 10 exceeded expectations could better car headache driving car daily like car developed trust car past year real reliability concern cel resolved software update going chalk oil leak bad luck find anyone else giulia forums anywhere problem shit happens supra burnt oil like crazy rather seal internal issues things work android auto car play flawless except one time froze nothing dailying 13000 km automatic wipers work consistently automatic climate control works properly buttons switch gear work expected niggles bugs car functions well daily operation probably one dependable things burn oil take photo dipstick measure pixels oil line months car leaking change impressive turbo charged engine contrary supra burnt 5x oil car leaked overall better expected nd quirks like overly sensitive passenger sensor seat belts retract properly automatic wipers work half time infotainment crashes build quality 8 5 10 major concerns going go ahead use supra father refreshed tesla model 3 basis comparison might argue fair expensive car interior still giulia comparable price cars build quality significantly better tesla supra touch points nice including steering wheel feels expensive large cold metal paddles minimum creaks rattles compared cars far far far less rattles creaks supra tesla feels like rolls royce comparison cars even close keep mind fix cluster surround rattle day 1 similar things supra doors shut solid clunk like vault flex door panel paint solid little orange peel seems hard thick noted dealer body panels align well cheap plastics places really matter like lower door pockets also true supra tesla foot hits exiting car want leather notable cheap areas centre column stalks overhead grab handles stalks cheap texture switch gear feels pretty good think supra bit solid feeling switches mean compare side side think complaints car build quality cabin 2015 design use dark materials feel cheap matters terms function rattles creaks daily 8 5 10 exceeds expectations comfortable quiet ride functional easy use cabin ask extremely comfortable ride n mode really know managed well damped complete night day difference tesla supra even parents 2014 e class car contemporary floats glides highway feel bumps intrusive quiet ride seems like giulia got extra sound deadening 2020 close window world fades away rolls royce excellent even price point little wind noise tire noise wonderful cabin easy use hvac controls right intuitive easy read excellent resolution refresh rate digital instrument cluster beautifully designed ease read well integrated matte centre infotainment display glare plenty bright works really comment much stock alfa ui seen year set car thing plug phone never see crucial function buried infotainment display pretty much cover carbon fibre whatever want car functional 100 love excellent driving position sparco carbon fibre bucket seats comfortable though lack bit lumbar support easy get 5 7 admittedly short lot foot space behind ample space child seat back especially carbon buckets lower profile standard seats rear seats fold ease fold flat audiophile speakers sound good better supra raise mids bit lower treble issues modulating brakes coming creep smooth stop think concern earlier giulias performance 9 5 10 greatest sports sedan ever made brakes kept picky found steering feel 458 spider inadequate found cayman gt4 understeer driven hard enough feel bit light front end higher speeds found steering supra dead vague trouble taking lines spirited drives nd mess modifications one favourite cars driving first generation brz terms chassis feel balance steering feel overall driver engagement involvement box giulia feels like car except 510 hp grip better aero engine begs beating car perfect box car ever driven first spirited drive remember yelling yes yes yes like mad man turn good zero understeer zero oversteer car rotates around well chassis super communicative steering light first loads enough become bit work corners communicate well porsche fun character engine begs revved power builds way red line imo sounds good drive harder harder sound becomes aggressive pops crackles system heats got much character magnificent engine transmission shifts fast race mode kicks back shift smoothly like videogame feel shift like aventador addicting puts smile face much character car main highlight car suspension tuning chassis steering whole thing greater sum parts absolutely intoxicating first time life literal dreams driving car instrument cluster race mode work art reminds lfa rev counter best thing good refresh rate discernible lag cheapen experience alfa knocked one park higher speed roads like example ones around la seems grip harder drive never driven car even porsche even ferrari felt planted confidence inspiring 160 200kph wide corners hard believe held world record sedan nordschleife stock tires driven man shirt really doubt modern sedan world fun drive intoxicating factory driven older giulias qvs hard like heard new mechanical rear diff 2024 model makes best model year improves everything predictability throttle response faster car conclusion hindsight buying car stupid financial logical decision alfa days may numbered north america dealer experience sucks depreciate maybe given next one might suv final best version car perfect 4 days total time car loaner year drove nd really worth wanted car since announced hyped mind decade absolutely crushed exceeded unreasonable expectations truly special last kind probably last real alfa romeo really doubt 20 years going regret 10k extra depreciation may m3 deal quirks got lackluster service likely reminisce old alfa romeo giulia smile fondly nearly every single time drive come home smile face tell wife great car happening even year later car greater sum parts truly feels special way modern cars anymore entering age cars class starting exceed 4000 lbs gigantic tablets interior many assists drift control hybridization electrification rear wheel steer 21 inch wheels hideous styling possibly subscription service cars like thing past privileged able one new thanks reading
1losgo3	993 porsche 911 speedster remastered gunther werks
1loshbz	trials quadrifoglio ownership 1 year owners update exactly 1 year since purchasing 2024 alfa romeo giulia quadrifoglio kinda similar post post similar length ownership going compare car supra think supra probably lemon though think made good arguments car even reliable still feel good product start negatives since probably interested negatives reliability dealership concerns 1 month ownership noticed drops oil garage took local alfa dealership diagnosed front crank seal seep ordered parts replaced car gone 2 days catch loaner asked pay uber said within vancouver live nearby suburb cost difference would 10 dollars got argument told mercedes bmw would treat people way guys already trouble treat customers took risk bought brand gave paid ride home back around 900km take anymore went local back roads race mode beat crap car huge grin face unfortunately front rotors developed hot spots started shaking braking rotors pads replaced warranty surprise probably entirely fault pads bedded properly two circumstances check engline light came upon starting car throttle pulsing infamous service electronic body control obd2 reader handy noted 10 different codes thrown cases cases knew probably nothing cycled ignition cel went away thousands km second time happened months later car started leak area back dealership gone 2 days mention cel issue really care probably software bug ended updating ecu software directly addressed bug softawre misread battery voltage late model giulia quadrifoglios told 10 years servicing car two cars front crank seal leaks mine 2023 speculated bad batch seals circulating update fixing leak rotors pads upgraded pads well car issues matter beating much harder used one time android auto froze system restarted build quality issues rattle front guage cluster surround already knew would issue purchasing car purchased foam instantly resolved day 1 small rattle driver side door audible really crank base music dealer applied foam significantly better small rattle overhead lights seems solved let see comes back winter dailying issues car low clearance 458 longer wheelbase centre car prone hitting taller speed bumps mindful fuel economy 15 2l 100km car begs drive like asshole almost launching every red light love big pillar mirror situation means visibility hampered left turns onto pedestrians heated seats steering wheel carbon bucket seats mild winters problem car idles nearly 1000 rpm gotta apply bit brake pressure get car sit still red light get fatiguing resolved putting neutral biggest problem dailying car hill start assist feature bit intrusive sometimes letting go brakes get car creep slight incline gotta give second move forward backwards performance issues front alignment limited sure done way front camber adjustable sits 0 5 degrees currently car handles incredibly well neutral worried messing brakes even porterfield r4s pads stock rotors okay get slight brake fade intense touge session brakes little feel behave differently depending feel best race mode pretty much drive car race mode get completely different animal torque limits like dynamic mode first 2nd possibly gears car feels much faster brakes better sensitive throttle stiffest suspension settings locked mode caviat get traction stability control none found issue ps4s tires hooks well chassis communicative well balanced lovely qualms driving car hard race mode bumpier roads bottom car low driving fast enough positives reliability 7 5 10 exceeded expectations could better car headache driving car daily like car developed trust car past year real reliability concern cel resolved software update going chalk oil leak bad luck find anyone else giulia forums anywhere problem shit happens supra burnt oil like crazy rather seal internal issues things work android auto car play flawless except one time froze nothing dailying 13000 km automatic wipers work consistently automatic climate control works properly buttons switch gear work expected niggles bugs car functions well daily operation probably one dependable things burn oil take photo dipstick measure pixels oil line months car leaking change impressive turbo charged engine contrary supra burnt 5x oil car leaked overall better expected nd quirks like overly sensitive passenger sensor seat belts retract properly automatic wipers work half time infotainment crashes build quality 8 5 10 major concerns going go ahead use supra father refreshed tesla model 3 basis comparison might argue fair expensive car interior still giulia comparable price cars build quality significantly better tesla supra touch points nice including steering wheel feels expensive large cold metal paddles minimum creaks rattles compared cars far far far less rattles creaks supra tesla feels like rolls royce comparison cars even close keep mind fix cluster surround rattle day 1 similar things supra doors shut solid clunk like vault flex door panel paint solid little orange peel seems hard thick noted dealer body panels align well cheap plastics places really matter like lower door pockets also true supra tesla foot hits exiting car want leather notable cheap areas centre column stalks overhead grab handles stalks cheap texture switch gear feels pretty good think supra bit solid feeling switches mean compare side side think complaints car build quality cabin 2015 design use dark materials feel cheap matters terms function rattles creaks daily 8 5 10 exceeds expectations comfortable quiet ride functional easy use cabin ask extremely comfortable ride n mode really know managed well damped complete night day difference tesla supra even parents 2014 e class car contemporary floats glides highway feel bumps intrusive quiet ride seems like giulia got extra sound deadening 2020 close window world fades away rolls royce excellent even price point little wind noise tire noise wonderful cabin easy use hvac controls right intuitive easy read excellent resolution refresh rate digital instrument cluster beautifully designed ease read well integrated matte centre infotainment display glare plenty bright works really comment much stock alfa ui seen year set car thing plug phone never see crucial function buried infotainment display pretty much cover carbon fibre whatever want car functional 100 love excellent driving position sparco carbon fibre bucket seats comfortable though lack bit lumbar support easy get 5 7 admittedly short lot foot space behind ample space child seat back especially carbon buckets lower profile standard seats rear seats fold ease fold flat audiophile speakers sound good better supra raise mids bit lower treble issues modulating brakes coming creep smooth stop think concern earlier giulias performance 9 5 10 greatest sports sedan ever made brakes kept picky found steering feel 458 spider inadequate found cayman gt4 understeer driven hard enough feel bit light front end higher speeds found steering supra dead vague trouble taking lines spirited drives nd mess modifications one favourite cars driving first generation brz terms chassis feel balance steering feel overall driver engagement involvement box giulia feels like car except 510 hp grip better aero engine begs beating car perfect box car ever driven first spirited drive remember yelling yes yes yes like mad man turn good zero understeer zero oversteer car rotates around well chassis super communicative steering light first loads enough become bit work corners communicate well porsche fun character engine begs revved power builds way red line imo sounds good drive harder harder sound becomes aggressive pops crackles system heats got much character magnificent engine transmission shifts fast race mode kicks back shift smoothly like videogame feel shift like aventador addicting puts smile face much character car main highlight car suspension tuning chassis steering whole thing greater sum parts absolutely intoxicating first time life literal dreams driving car instrument cluster race mode work art reminds lfa rev counter best thing good refresh rate discernible lag cheapen experience alfa knocked one park higher speed roads like example ones around la seems grip harder drive never driven car even porsche even ferrari felt planted confidence inspiring 160 200kph wide corners hard believe held world record sedan nordschleife stock tires driven man shirt really doubt modern sedan world fun drive intoxicating factory driven older giulias qvs hard like heard new mechanical rear diff 2024 model makes best model year improves everything predictability throttle response faster car conclusion hindsight buying car stupid financial logical decision alfa days may numbered north america dealer experience sucks depreciate maybe given next one might suv final best version car perfect 4 days total time car loaner year drove nd really worth wanted car since announced hyped mind decade absolutely crushed exceeded unreasonable expectations truly special last kind probably last real alfa romeo really doubt 20 years going regret 10k extra depreciation may m3 deal quirks got lackluster service likely reminisce old alfa romeo giulia smile fondly nearly every single time drive come home smile face tell wife great car happening even year later car greater sum parts truly feels special way modern cars anymore entering age cars class starting exceed 4000 lbs gigantic tablets interior many assists drift control hybridization electrification rear wheel steer 21 inch wheels hideous styling possibly subscription service cars like thing past privileged able one new see selling want keep long literally cannot think another car replace way things going probably wont extended warranty 7 years godspeed thanks reading
1losmjd	good idea post description new top adult driven recent maintenance owned eleven years drive anywhere 2001 porsche boxster convertible 2d 7 990 usd sold 2nd owner locally would fun car means daily driver limited knowledge car maintenance want look learning fun car also says manual would learning drive well always wanted porsche hear good starter cars get car friends anyone knows enough check car alone never looked buying used car private seller wanted get ideas look based google searches heard good ask ims esm done recommendations ideas bad idea input appreciated
1losnzy	parents terrorizing dealing car accident fault vent tldr long vent parents terrorizing major car accident 0 fault course claim done everything gotten even basic help nothing time money neither slam dunk terrorize life ruining event currently midst lawsuit car accident fault driver floored stop sign hit street busy traffic dead still struggling whiplash seems decimated left side spine neck l5 junction super important parts work shit job expected go work next day change schedule responsibilities hell seems work making paper trail fire reasons clear able work full 40h part time begin anyway get ball rolling initial drs appts call day accident er night lawyer struggling get paperwork done insurance clearly trying screw left right center parents whole time neither work immediately blamed could get sentence accident happened called say hit tried jokingly saying firemen cop thought one hit someone cop firemen think funny fireman said paraphrasing daughter handled spinout well thought ex military raced cars dead helped picking car towyard getting paperwork calls done making food getting hospital doctor appointments finding new car budget anything lawyers terrorized car ride made excessively long 1h 15min drive rental car place decked nmom driving started psychotically screaming broke camera record one believe otherwise called family members screaming lies going kill bruised terrified confession wanted pretty obviously full screamed tantrummed costco parking lot threatened call cops crazy eyed screamed every day past week lawyer going take everything idiot know better know insurance helping accept insurance lowballed also stole car towyard without verbal written permission lot far tow mechanic know breaks state laws think ways lot eye bulging screaming knowing better mocking getting help none offered course lazily sat around done absolutely nothing pass pain second get home every day insurance seriously tried lowball like nothing else receipts prove brand new tires spark plugs pictures prove car genuinely pristine condition gotten inspection ready sell higher value weeks nothing hood damaged accident cars expensive nowadays even used getting terrorized penny pinching wanting evaluation pennies thousand insurance job suspiciously tried everything phone unresponsive lies getting emails try keep everything writing according parents rage screaming makes ungrateful psychotic makes stupid screamed bloody murder fingers face screamed written found 2 cars truly amazing deals barely budget approved lowest rate finance rest hard pay quickly barely used stupid know mechanic know cars went separate mechanics know get opinion cars nmom showed went buy car going repeatedly try say imply salesman well put car name know bad give better interest rate know irresponsible bad money salesman looked dumbfounded said daughter best possible rate bank lender offer checked excellent credit clearly bad money stopped mom tracks later embarass showing truly idea car market outside porsches guy jaw almost dropped whole financing warranty spiel paperwork signed main salesman sat car going home make sure knew features driving away etc mom driven away fast enough said daughter age similar situation years earlier heard salesman day put negotiation wringer got solid handled really well giving daughter negotiation tips let mom get bad situation yet another example life outsider witnesses nmom manipulative behaving best sliding everything right parent want figure fix shredded back bad way make better income actually free nightmare idea expect lawsuit genuinely hope settlement medical car fees enough move safely give time get better job make car accident injuries worse feel crazy saying hope works secretly blessing disguise
1lot59u	poți găsi toate cuvintele masini 2025 07 01
1lotich	awesome find box set clean
1lottfd	june 2025 reported 130 videos spam misinformation
1lou6fv	fh5 w car list h credits trying get hands following cars porsche 911 gunther bmw m3 gts jaguar f type svr willing sell shoot dm
1lou6kn	mezgr app lot fun mezgr app community giving lot great feedback thank
1lou7vr	silver series chase available dm price
1lou9x6	5000km 718 spyder hit 5000km two months ownership stop driving thing stop photo
1louai7	looking nothing rare good looking casting adds porsche collection
1loudkx	porsche getting detailed green green paython nature habitat
1louens	taking care porsche spyder rs maybe way pts want take extremely good care car also use regularly thinking going road home wash kit realized good going ppf whole car ceramic also pff interior carbon fiber wanted recommendations assuming driving 5 10x month often would wash car b would take car get hand washed would take detailer hand wash would anything else maintain car looks wise thing think sunshade parked outside blast interior
1loumle	th collection far
1louubs	head display blurry got brand new cayenne coupe first time got head display porsche noticed display reflection windshield appears quite blurry crisp used cars like old bmw 550i gt 2015 since appear adjustable sharpness setting wonder dealership might left protective plastic cover factory display touch hud screen behind steering wheel feel like solid surface like phone screen rather flexible plastic layer gives touch sure actual part hud screen protective foil find corners tabs usually remove foil worried try peel top layer advice hud screen actual solid screen flexible plastic ish top layer thanks advance
1lov1rn	supercar recommendation market new car budget low mid 300k would appreciate suggestions much car person appreciate good looking sounding car looking something daily drive generally 25 miles per day curb appeal reliability probably visit track twice year deciding factor climate live usually rainy months year well considered porsche 911 turbo hate similar porsche models look visited dealership eventually came across mclaren arturas love look read horror stories reliability happy proven wrong though worth considering test driving
1lov27w	loose cars sale tomica mainline skyline bnr32 600 majorette porsche 911 gt3 cup 350 hotwheels 82 skyline kdr30 250 majorette bugatti chiron pur sport 350
1lov2cq	first porsche looking first porsche car 1999 low kms 70 000 one owner full service history everything seems great condition wise automatic context manual really option know going fear gear tiptronic goal daily enjoy porsche track race drive 10 000kms year think decision
1lov6e9	finally roxy recieved toymarche com
1lovle1	zweitwagenwahl hallo die runde ich stehe momentan vor der angenehmen situation das meine frau der meinung ist ich könnte mir auch mal wieder gönnen gesagt getan die wahl eine netten zweitwagens steht aufgrund günstiger umstände ist das budget dafür relativ unlimmitiert ein paar vorgaben gibt es aber doch durch 2 kinder müssen also mind 4 leute platz haben ich kaufe grundsätzlich keine neuwagen daher hätte ich gerne einen jungen gebrauchten 2 3 jahre alt aufgrund von stadtverkehr und parkplatzsuche ich auf keinen fall ein größeres auto also ungefähr 4 7m sollten maximal sein da es sich um einen reinen luxusgegenstand für mich handelt ich damit auch gelegentlich spaß haben sprich leistung darf gerne sein momentan habe ich folgende modelle der engeren wahl golf r ca 40k audi rs3 ca 50k bmw 135i ca 42k mercedes a45 ca 45k porsche macan ca 80k ja ich weiß der passt nicht ganz aber finde den irgendwie schön und praktisch hyundai i30n ca 30k wie man der liste sieht ist diese aber wahnsinnig einfallslos wer also ein paar exotische vorschläge oder andere ideen hat kann die gerne schreiben grundsätzlich bin ich übrigens nicht gegen e autos habe aber das gefühl das im kompaktbereich die auswahl eher gering ist danke für euer feedback
1lovmz0	narrative bof deleted recent stream think deleted hiding inner circle talking smacc warehouse workers homies fmw cast say cast bro probably ego trip fake bragged making probably telling homies huge numbers bro slipped show going lie still great numbers average person life streams shopping new whip porsche store know means shit bragging
1lovnsf	1 hour endurance race gt7 im white blue porsche thought left enougth space black toyoya pass fault need youre thoughts takes blame pov 1 clip mine
1lovsoz	luckiest bb winner save rachel bb14 lawon volunteer get evicted thought secret power also mainly porsche opened pandora box saved rachel jordan gotten paired veto hm brendon winning back game yall consider luckiest winner
1lovyu1	nsx different set wheels alongside feedback tt02r changed wheel box stock tt02 nsx wheels arched 5 spoke wheels silver item 51071 says porsche carrera gt style putting nsx say turned quite sexy tt02r dat finally say much upgrade upgrade noticeable still entry level kit notable hopups maybe bought expectations could change life mistake 1st place important note tt02r bad kit expectations roof steering still plastic bits bigggest turn blood still boils think everytime go bed recommend tt02r 100 get tt02 small necessary hopups tamiya super mini shocks servo mount full steering upgrade good go get full steering upgrade disappointment comes expectations definitely still fun
1low0r1	something wrong clutch porsche cup start new porsche cup always granny start hitting gas light goes green everybody says dual clutch start faster problem every time try dual clutch start happens hold clutch gas little long seems like clutch gets stuck release switch gears get power happens need fully stop car move using 44 bitepoint knows prevent
1low57n	suggestions week long user hello first love app love idea behind would like share ideas app guys wanna stress understand app developed one man team expect everything happen tomorow maybe okay ideas function app 1 would love see filters makers car e porsche audi bmw last brand would fantasy made models 2 would love ability click mini series sub collection wheter premiums call culture subcollection mains example silhouettes series example click 300zx see miniseries silhouettes click would see cars said series including chase one social 1 would love ability look users far understanding start following community page 2 add first point would love app messenger adding ability communicate users 3 marketplace trading place idea would selling necesarilly primarily posting cars trade ideally special icon maybe posting car would want really would pinnacle social stuff would understand děv decides go route might loads legal stuff surrounding thanks advance apologize spelling series english first language
1lowagh	carrera r 2 7 minigt writing rs considered sale post typed seperately minigt model
1lowf97	diva arrived
1lowk2f	best spots yesterday czech republic porsche 911 gt3 touring england ferrari f12 berlinetta n largo bugatti veyron ford gt lamborghini aventador svj crashed porsche 997 targa 4s aston martin cygnet mercedes maybach gls 600 reva g wiz lamborghini aventador sv ferraro 250 gto lamborghini aventador porsche gt2 rs mr 1 77 porsche 930 turbo mclaren 675lt ferrari 458 speciale ferrari 458 italia 1974 amc javelin volvo tp21 aston martin dbs 770 tesla roadster panther kallista japan toyota corolla ae86 abarth 565 bodykit nissan gtr ferrari 458 italia mercedes maybach class honda s2000 nissan skyline r34 nissan skyline r32 nissan skyline r33 nissan skyline r32 toyota supra a90 nissan skyline r34 tuned nissan skyline r34 tuned nissan skyline r34 nissan skyline r34 nissan skyline r33 nissan skyline r35 tuned luxembourg mk indy r volkswagen golf country new zealend toyota supra a80 ford fairlane 500 skyliner spain aston martin valkyrie ford gt koenigsegg ccr koenigsegg regera viessmann mf5
1lown13	porsche fam dropping serious porsche love lately hope fellow collectors thrilled receive create jdm turn next
1lownde	porsche fam dropping serious porsche love lately hope fellow collectors thrilled receive create jdm turn next
1lowp6q	porsche gt3 rs porsche gt3 rs race mode
1lox0ak	much going dusseldorf germany toyota mk5 supra porsche 911 targa random e class dive bombs
1lox7wt	race recap 2025 24 hours le mans finally hey everyone sorry late post full breakdown iconic 2025 24 hours le mans final hypercar results top 3 1 83 af corse ferrari 499p robert kubica yifei ye philip hanson 387 laps 2 6 porsche penske 963 kevin estre laurens vanthoor matt campbell 14 084s 3 51 af corse ferrari alessandro pier guidi james calado antonio giovinazzi 28 487s ferrari claimed third consecutive le mans victory time powerhouse trifecta talent teamwork highlights takeaways robert kubica emerged le mans first ever polish overall winner emotional comeback story 14 years near fatal crash reuters com privateer ferrari af corse triumphed factory backing making sensational upset endurance racing porsche pushed hard sealing second place denying ferrari podium sweep racingnews365 com let discuss favorite moment race feel 83 privateer win factory teams got predictions picks next year drop apologies delay thanks sticking around catch pit lane player one reloaded
1loxfqm	umfrage porsche audi konfigurieren bachelorarbeit servus alle autointeressierten ich schreibe aktuell meine bachelorarbeit zum thema psychologische optimierung von fahrzeugkonfiguratoren es geht darum ein auto porsche oder audi zu konfigurieren und danach einen kurzen 5 minütigen fragebogen auszufüllen wie lange ihr das auto konfiguriert ist eure sache wenn ihr keinen bock mehr habt skippt ihr zur survey vielleicht hat ja der eine oder andere lust mitzumachen würde mir auf jeden fall sehr weiterhelfen ist natürlich alles anonym und nur im namen der wissenschaft
1loxjwo	iso reasonable price price 1 set 5 normal price 1 set 5 including chase place normal please dm best
1loxkab	iso reasonable price price 1 set 5 normal price 1 set 5 including chase place normal please dm best
1loxtjz	looking forward sell sealed mint 80 og roxy dm offers
1loy0tl	mod team logos anyone know mod different team logos f1m24 seen mods porsche audi example want change logo teams save files need look inside game help would appreciated thanks
1loyb5l	anyone know remove white bar samsung tab know pressed
1loyc6i	featured f1 movie porsche gt3 r driven brad movie car 2023 porsche gt3 r creator justviggo sharecode 128 674 303
1loychl	featured f1 movie porsche gt3 r driven brad movie car 2023 porsche gt3 r creator justviggo sharecode 128 674 303
1loydad	featured f1 movie porsche gt3 r driven brad movie car 2023 porsche gt3 r creator justviggo sharecode 128 674 303
1loydvx	featured f1 movie porsche gt3 r driven brad movie car 2023 porsche gt3 r creator justviggo sharecode 128 674 303
1loyler	porsche 963 lmdh le mans daytona h prototype acura grand prix long beach
1loyw5s	tomorrow able get mercedes clk gtr finally july 2nd end fomo update holding breath car big late 90s gt1 fan also think add 1998 porsche 911 gt1 game maybe gt1 themed event something
1loywwm	spa 24 team teammates hey looking team spa 24 race next weekend unfortunately people would normally events unavailable currently 2 2k ir care others want event happily drive gt3s mainly use porsche fussed uk based anyone interested send discord info cheers
1lozbdx	xbox app forza horizon 4 beat clean desktop
1lozg3b	xiaomi made cheap ferrari ev needs porsche
1lozqnx	amazon anybody looking mrp
1lozsye	porsche gt4 rs 2298x2236
1lp057y	independent porsche mechanic looking someone nashua amherst manchester area
1lp0gbh	finaly finished setup setup fanatec podium dd2 clubsport steering wheel porsche 911 gt3 r clubsport pedals v3 inverted clubsport shifter sq clubsport handbrake oplite gtr s3 koorui 34 screen nurburgring led home made
1lp0hqe	hw premium modeller ya da mini gt ile takaslık stanbul pendik tekliflerinizi bekliyorum
1lp0krp	look found took right one sure good pick videos seen usually glossiest ones better lol plus like 2 3 type left one took one right 3 btw
1lp0okp	want support meka added game either overlord dae hyun mechanics engineers would fit support role perfectly overlord drone could healing dae hyun referenced lot lately porsche video voice lines christmas comic abilities dva stadium mode could see join ow lore like efi recently plus community asking dva related hero years
